activate the bomb	{"dialogue_type": "HUMAN_GIVE_COMMAND", "action_sequence": [{"action_type": "OTHERACTION", "reference_object": {"has_name": [[2, 2]]}}]}
add churches to the city	{"dialogue_type": "HUMAN_GIVE_COMMAND", "action_sequence": [{"action_type": "SPAWN", "location": {"location_type": "REFERENCE_OBJECT", "reference_object": {"contains_coreference": "no", "has_name": [[4, 4]]}}, "reference_object": {"has_name": [[1, 1]]}}]}
add diamond ore to my inventory	{"dialogue_type": "HUMAN_GIVE_COMMAND", "action_sequence": [{"action_type": "OTHERACTION", "location": {"location_type": "REFERENCE_OBJECT", "reference_object": {"contains_coreference": "no", "has_name": [[4, 4], [5, 5]]}}, "reference_object": {"has_name": [[2, 2]], "has_block_type": [[1, 1]]}}]}
add supermarkets to the city	{"dialogue_type": "HUMAN_GIVE_COMMAND", "action_sequence": [{"action_type": "BUILD", "location": {"location_type": "REFERENCE_OBJECT", "reference_object": {"contains_coreference": "no", "has_name": [[4, 4]]}}, "schematic": {"has_name": [[1, 1]]}}]}
answer my question about the map	{"dialogue_type": "HUMAN_GIVE_COMMAND", "action_sequence": [{"action_type": "ANSWER"}]}
answer the operator	{"dialogue_type": "HUMAN_GIVE_COMMAND", "action_sequence": [{"action_type": "OTHERACTION", "reference_object": {"has_name": [[2, 2]]}}]}
answer the phone please	{"dialogue_type": "HUMAN_GIVE_COMMAND", "action_sequence": [{"action_type": "OTHERACTION", "reference_object": {"has_name": [[2, 2]]}}]}
approach closest player	{"dialogue_type": "HUMAN_GIVE_COMMAND", "action_sequence": [{"action_type": "MOVE", "location": {"location_type": "REFERENCE_OBJECT", "reference_object": {"has_name": [[2, 2]], "location": {"location_type": "AGENT_POS", "relative_direction": "NEAR"}}}}]}
ask the character about danger	{"dialogue_type": "HUMAN_GIVE_COMMAND", "action_sequence": [{"action_type": "OTHERACTION", "reference_object": {"has_name": [[2, 2]]}}]}
bot destroy the wall	{"dialogue_type": "HUMAN_GIVE_COMMAND", "action_sequence": [{"action_type": "DESTROY", "reference_object": {"has_name": [[3, 3]]}}]}
bot fill all the beakers with 50 ml of water	{"dialogue_type": "HUMAN_GIVE_COMMAND", "action_sequence": [{"action_type": "FILL", "has_block_type": [[6, 6], [7, 7], [8, 8], [9, 9]], "reference_object": {"has_name": [[4, 4]]}, "repeat": {"repeat_key": "ALL"}}]}
bot go into hibernation	{"dialogue_type": "HUMAN_GIVE_COMMAND", "action_sequence": [{"action_type": "OTHERACTION", "reference_object": {"has_name": [[0, 0]]}}]}
bot please dig a large hole	{"dialogue_type": "HUMAN_GIVE_COMMAND", "action_sequence": [{"action_type": "DIG", "schematic": {"has_name": [[5, 5]], "has_size": [[4, 4]]}}]}
bot please fill it up immediately	{"dialogue_type": "HUMAN_GIVE_COMMAND", "action_sequence": [{"action_type": "FILL", "reference_object": {"contains_coreference": "yes"}}]}
bot stop moving	{"dialogue_type": "HUMAN_GIVE_COMMAND", "action_sequence": [{"action_type": "STOP", "target_action_type": [[2, 2]]}]}
bot stop scanning the sitting room	{"dialogue_type": "HUMAN_GIVE_COMMAND", "action_sequence": [{"action_type": "STOP", "target_action_type": [[2, 2], [4, 4], [5, 5]]}]}
bounce up and down 5 times	{"dialogue_type": "HUMAN_GIVE_COMMAND", "action_sequence": [{"action_type": "OTHERACTION", "repeat": {"repeat_key": "FOR", "repeat_count": [[4, 4]]}}]}
break block	{"dialogue_type": "HUMAN_GIVE_COMMAND", "action_sequence": [{"action_type": "DESTROY", "reference_object": {"has_name": [[1, 1]]}}]}
break that window	{"dialogue_type": "HUMAN_GIVE_COMMAND", "action_sequence": [{"action_type": "DESTROY", "reference_object": {"has_name": [[2, 2]]}}]}
bring a shovel to location 29 16 32	{"dialogue_type": "HUMAN_GIVE_COMMAND", "action_sequence": [{"action_type": "OTHERACTION", "location": {"location_type": "COORDINATES", "coordinates": [[5, 5], [6, 6], [7, 7]]}, "reference_object": {"location": {"location_type": "COORDINATES"}, "has_name": [[2, 2]]}}]}
bring it closer to the table	{"dialogue_type": "HUMAN_GIVE_COMMAND", "action_sequence": [{"action_type": "OTHERACTION", "location": {"location_type": "REFERENCE_OBJECT", "relative_direction": "NEAR", "reference_object": {"contains_coreference": "no", "has_name": [[5, 5]]}}, "reference_object": {"contains_coreference": "yes"}}]}
build a 1 x 1 tower going straight up for 25 blocks	{"dialogue_type": "HUMAN_GIVE_COMMAND", "action_sequence": [{"action_type": "BUILD", "schematic": {"has_name": [[5, 5]], "has_height": [[10, 10], [11, 11]], "has_length": [[4, 4]], "has_width": [[2, 2]]}}]}
build a 15 by 15 fence	{"dialogue_type": "HUMAN_GIVE_COMMAND", "action_sequence": [{"action_type": "BUILD", "schematic": {"has_name": [[5, 5]], "has_height": [[2, 2]]}}]}
build a block at the top of the pyramid	{"dialogue_type": "HUMAN_GIVE_COMMAND", "action_sequence": [{"action_type": "BUILD", "location": {"location_type": "REFERENCE_OBJECT", "relative_direction": "UP", "reference_object": {"contains_coreference": "no", "has_name": [[8, 8]]}}, "schematic": {"has_name": [[2, 2]]}}]}
build a boat	{"dialogue_type": "HUMAN_GIVE_COMMAND", "action_sequence": [{"action_type": "BUILD", "schematic": {"has_name": [[2, 2]]}}]}
build a bridge across the creek	{"dialogue_type": "HUMAN_GIVE_COMMAND", "action_sequence": [{"action_type": "BUILD", "location": {"location_type": "REFERENCE_OBJECT"}, "schematic": {"has_name": [[2, 2]]}}]}
build a bridge near the mountain	{"dialogue_type": "HUMAN_GIVE_COMMAND", "action_sequence": [{"action_type": "BUILD", "location": {"location_type": "REFERENCE_OBJECT", "relative_direction": "NEAR", "reference_object": {"contains_coreference": "no", "has_name": [[5, 5]]}}, "schematic": {"has_name": [[2, 2]]}}]}
build a bridge over the small lake	{"dialogue_type": "HUMAN_GIVE_COMMAND", "action_sequence": [{"action_type": "BUILD", "location": {"location_type": "REFERENCE_OBJECT", "relative_direction": "UP", "reference_object": {"contains_coreference": "no", "has_name": [[5, 5], [6, 6]]}}, "schematic": {"has_name": [[2, 2]]}}]}
build a cabin	{"dialogue_type": "HUMAN_GIVE_COMMAND", "action_sequence": [{"action_type": "BUILD", "schematic": {"has_name": [[2, 2]]}}]}
build a castle with stone	{"dialogue_type": "HUMAN_GIVE_COMMAND", "action_sequence": [{"action_type": "BUILD", "schematic": {"has_name": [[2, 2]], "has_block_type": [[4, 4]]}}]}
build a couch	{"dialogue_type": "HUMAN_GIVE_COMMAND", "action_sequence": [{"action_type": "BUILD", "schematic": {"has_name": [[2, 2]]}}]}
build a door on one side of the pyramid to make a house	{"dialogue_type": "HUMAN_GIVE_COMMAND", "action_sequence": [{"action_type": "BUILD", "location": {"location_type": "REFERENCE_OBJECT", "reference_object": {"contains_coreference": "no", "has_name": [[4, 4], [5, 5], [6, 6], [8, 8]]}}, "schematic": {"has_name": [[2, 2]]}}]}
build a drawbridge	{"dialogue_type": "HUMAN_GIVE_COMMAND", "action_sequence": [{"action_type": "BUILD", "schematic": {"has_name": [[2, 2]]}}]}
build a fire	{"dialogue_type": "HUMAN_GIVE_COMMAND", "action_sequence": [{"action_type": "BUILD", "schematic": {"has_name": [[2, 2]]}}]}
build a fireplace	{"dialogue_type": "HUMAN_GIVE_COMMAND", "action_sequence": [{"action_type": "BUILD", "schematic": {"has_name": [[2, 2]]}}]}
build a footrest	{"dialogue_type": "HUMAN_GIVE_COMMAND", "action_sequence": [{"action_type": "BUILD", "schematic": {"has_name": [[2, 2]]}}]}
build a fort in the hole	{"dialogue_type": "HUMAN_GIVE_COMMAND", "action_sequence": [{"action_type": "BUILD", "location": {"location_type": "REFERENCE_OBJECT", "relative_direction": "INSIDE", "reference_object": {"contains_coreference": "no", "has_name": [[5, 5]]}}, "schematic": {"has_name": [[2, 2]]}}]}
build a gift for bot.0040414.63	{"dialogue_type": "HUMAN_GIVE_COMMAND", "action_sequence": [{"action_type": "BUILD", "schematic": {"has_name": [[2, 2], [3, 3], [4, 4]]}}]}
build a glass roof in its place	{"dialogue_type": "HUMAN_GIVE_COMMAND", "action_sequence": [{"action_type": "BUILD", "location": {"contains_coreference": "yes"}, "schematic": {"has_name": [[3, 3]], "has_block_type": [[2, 2]]}}]}
build a house	{"dialogue_type": "HUMAN_GIVE_COMMAND", "action_sequence": [{"action_type": "BUILD", "schematic": {"has_name": [[2, 2]]}}]}
build a house where the last one was destroyed	{"dialogue_type": "HUMAN_GIVE_COMMAND", "action_sequence": [{"action_type": "BUILD", "location": {"location_type": "REFERENCE_OBJECT", "reference_object": {"contains_coreference": "no", "has_name": [[3, 3], [5, 5], [6, 6], [7, 7], [8, 8]]}}, "schematic": {"has_name": [[2, 2]]}}]}
build a ladder	{"dialogue_type": "HUMAN_GIVE_COMMAND", "action_sequence": [{"action_type": "BUILD", "schematic": {"has_name": [[2, 2]]}}]}
build a large watchtower	{"dialogue_type": "HUMAN_GIVE_COMMAND", "action_sequence": [{"action_type": "BUILD", "schematic": {"has_name": [[3, 3]], "has_size": [[2, 2]]}}]}
build a mansion	{"dialogue_type": "HUMAN_GIVE_COMMAND", "action_sequence": [{"action_type": "BUILD", "schematic": {"has_name": [[2, 2]]}}]}
build a mineshaft	{"dialogue_type": "HUMAN_GIVE_COMMAND", "action_sequence": [{"action_type": "BUILD", "schematic": {"has_name": [[2, 2]]}}]}
build a new building in the left side	{"dialogue_type": "HUMAN_GIVE_COMMAND", "action_sequence": [{"action_type": "BUILD", "location": {"location_type": "REFERENCE_OBJECT", "relative_direction": "INSIDE", "reference_object": {"contains_coreference": "no", "has_name": [[6, 6], [7, 7]]}}, "schematic": {"has_name": [[3, 3]], "has_tag": [[2, 2]]}}]}
build a new building with a swimming pool	{"dialogue_type": "HUMAN_GIVE_COMMAND", "action_sequence": [{"action_type": "BUILD", "schematic": {"has_name": [[3, 3]], "has_tag": [[2, 2], [4, 4], [6, 6], [7, 7]]}}]}
build a new wall	{"dialogue_type": "HUMAN_GIVE_COMMAND", "action_sequence": [{"action_type": "BUILD", "schematic": {"has_name": [[3, 3]], "has_tag": [[2, 2]]}}]}
build a pc	{"dialogue_type": "HUMAN_GIVE_COMMAND", "action_sequence": [{"action_type": "BUILD", "schematic": {"has_name": [[2, 2]]}}]}
build a shed	{"dialogue_type": "HUMAN_GIVE_COMMAND", "action_sequence": [{"action_type": "BUILD", "schematic": {"has_name": [[2, 2]]}}]}
build a shelter	{"dialogue_type": "HUMAN_GIVE_COMMAND", "action_sequence": [{"action_type": "BUILD", "schematic": {"has_name": [[2, 2]]}}]}
build a small house	{"dialogue_type": "HUMAN_GIVE_COMMAND", "action_sequence": [{"action_type": "BUILD", "schematic": {"has_name": [[3, 3]], "has_size": [[2, 2]]}}]}
build a stairway	{"dialogue_type": "HUMAN_GIVE_COMMAND", "action_sequence": [{"action_type": "BUILD", "schematic": {"has_name": [[2, 2]]}}]}
build a structure with 5 block high walls a flat roof and a two block opening for the door	{"dialogue_type": "HUMAN_GIVE_COMMAND", "action_sequence": [{"action_type": "BUILD", "schematic": {"has_name": [[2, 2]], "has_height": [[4, 4]], "has_width": [[13, 13], [14, 14], [15, 15], [16, 16], [18, 18]], "has_tag": [[9, 9], [10, 10]]}}]}
build a tower	{"dialogue_type": "HUMAN_GIVE_COMMAND", "action_sequence": [{"action_type": "BUILD", "schematic": {"has_name": [[2, 2]]}}]}
build a tower in place of the pyramid	{"dialogue_type": "HUMAN_GIVE_COMMAND", "action_sequence": [{"action_type": "BUILD", "location": {"location_type": "REFERENCE_OBJECT", "reference_object": {"contains_coreference": "no", "has_name": [[7, 7]]}}, "schematic": {"has_name": [[2, 2]]}}]}
build a tower where enemy tower was	{"dialogue_type": "HUMAN_GIVE_COMMAND", "action_sequence": [{"action_type": "BUILD", "location": {"location_type": "REFERENCE_OBJECT", "reference_object": {"contains_coreference": "no", "has_name": [[3, 3], [4, 4], [5, 5], [6, 6]]}}, "schematic": {"has_name": [[2, 2]]}}]}
build a tunnel	{"dialogue_type": "HUMAN_GIVE_COMMAND", "action_sequence": [{"action_type": "BUILD", "schematic": {"has_name": [[2, 2]]}}]}
build a wall on one side of the bridge	{"dialogue_type": "HUMAN_GIVE_COMMAND", "action_sequence": [{"action_type": "BUILD", "location": {"location_type": "REFERENCE_OBJECT", "reference_object": {"contains_coreference": "no", "has_name": [[3, 3], [4, 4], [5, 5], [6, 6], [8, 8]]}}, "schematic": {"has_name": [[2, 2]]}}]}
build a wood oven for pizza	{"dialogue_type": "HUMAN_GIVE_COMMAND", "action_sequence": [{"action_type": "BUILD", "schematic": {"has_name": [[3, 3]], "has_block_type": [[2, 2]]}}]}
build all the blocks you will see	{"dialogue_type": "HUMAN_GIVE_COMMAND", "action_sequence": [{"action_type": "BUILD", "schematic": {"has_name": [[3, 3]], "has_tag": [[1, 1], [4, 4], [5, 5], [6, 6]]}}]}
build another level	{"dialogue_type": "HUMAN_GIVE_COMMAND", "action_sequence": [{"action_type": "BUILD", "schematic": {"has_name": [[1, 1], [2, 2]]}}]}
build it a house	{"dialogue_type": "HUMAN_GIVE_COMMAND", "action_sequence": [{"action_type": "BUILD", "schematic": {"has_name": [[3, 3]]}}]}
build me a cabin	{"dialogue_type": "HUMAN_GIVE_COMMAND", "action_sequence": [{"action_type": "BUILD", "schematic": {"has_name": [[3, 3]]}}]}
build me a coffee table	{"dialogue_type": "HUMAN_GIVE_COMMAND", "action_sequence": [{"action_type": "BUILD", "schematic": {"has_name": [[3, 3], [4, 4]]}}]}
build several pyramids	{"dialogue_type": "HUMAN_GIVE_COMMAND", "action_sequence": [{"action_type": "BUILD", "schematic": {"has_name": [[2, 2]], "has_tag": [[1, 1]]}}]}
build the room	{"dialogue_type": "HUMAN_GIVE_COMMAND", "action_sequence": [{"action_type": "BUILD", "schematic": {"has_name": [[2, 2]]}}]}
build with rock	{"dialogue_type": "HUMAN_GIVE_COMMAND", "action_sequence": [{"action_type": "BUILD"}]}
bury this treasure	{"dialogue_type": "HUMAN_GIVE_COMMAND", "action_sequence": [{"action_type": "OTHERACTION", "reference_object": {"contains_coreference": "yes", "has_name": [[2, 2]]}}]}
buy some gunpowder	{"dialogue_type": "HUMAN_GIVE_COMMAND", "action_sequence": [{"action_type": "OTHERACTION", "reference_object": {"has_name": [[2, 2]]}}]}
change the bed in this room to be king size	{"dialogue_type": "HUMAN_GIVE_COMMAND", "action_sequence": [{"action_type": "OTHERACTION", "location": {"location_type": "REFERENCE_OBJECT", "relative_direction": "INSIDE", "reference_object": {"contains_coreference": "no", "has_name": [[4, 4], [5, 5]]}}, "reference_object": {"has_name": [[2, 2]]}}]}
clean up the rubble for the princess	{"dialogue_type": "HUMAN_GIVE_COMMAND", "action_sequence": [{"action_type": "OTHERACTION", "reference_object": {"has_name": [[3, 3]]}}]}
climb out	{"dialogue_type": "HUMAN_GIVE_COMMAND", "action_sequence": [{"action_type": "MOVE", "location": {"location_type": "AGENT_POS", "relative_direction": "AWAY"}}]}
close it	{"dialogue_type": "HUMAN_GIVE_COMMAND", "action_sequence": [{"action_type": "OTHERACTION", "reference_object": {"contains_coreference": "yes"}}]}
collect some firewood	{"dialogue_type": "HUMAN_GIVE_COMMAND", "action_sequence": [{"action_type": "OTHERACTION", "reference_object": {"has_name": [[2, 2]]}}]}
collect them	{"dialogue_type": "HUMAN_GIVE_COMMAND", "action_sequence": [{"action_type": "OTHERACTION", "reference_object": {"contains_coreference": "yes"}}]}
collect wood in the forest	{"dialogue_type": "HUMAN_GIVE_COMMAND", "action_sequence": [{"action_type": "OTHERACTION", "location": {"location_type": "REFERENCE_OBJECT", "relative_direction": "INSIDE", "reference_object": {"contains_coreference": "no", "has_name": [[4, 4]]}}, "reference_object": {"has_name": [[1, 1]]}}]}
compact yourself into the small form you can possible	{"dialogue_type": "HUMAN_GIVE_COMMAND", "action_sequence": [{"action_type": "OTHERACTION", "reference_object": {"has_name": [[1, 1]]}}]}
complete building of pond	{"dialogue_type": "HUMAN_GIVE_COMMAND", "action_sequence": [{"action_type": "FREEBUILD", "reference_object": {"has_name": [[3, 3]]}}]}
complete closest player 's building project	{"dialogue_type": "HUMAN_GIVE_COMMAND", "action_sequence": [{"action_type": "FREEBUILD", "reference_object": {"has_name": [[4, 4], [5, 5]], "has_tag": [[1, 1], [2, 2], [3, 3]]}}]}
complete my quest	{"dialogue_type": "HUMAN_GIVE_COMMAND", "action_sequence": [{"action_type": "FREEBUILD", "reference_object": {"has_name": [[2, 2]]}}]}
complete the bridge	{"dialogue_type": "HUMAN_GIVE_COMMAND", "action_sequence": [{"action_type": "FREEBUILD", "reference_object": {"has_name": [[2, 2]]}}]}
complete the bridge with stone	{"dialogue_type": "HUMAN_GIVE_COMMAND", "action_sequence": [{"action_type": "FREEBUILD", "reference_object": {"has_name": [[2, 2]]}}]}
complete the building of the base	{"dialogue_type": "HUMAN_GIVE_COMMAND", "action_sequence": [{"action_type": "FREEBUILD", "reference_object": {"has_name": [[5, 5]]}}]}
complete the east wall	{"dialogue_type": "HUMAN_GIVE_COMMAND", "action_sequence": [{"action_type": "FREEBUILD", "reference_object": {"location": {}, "has_name": [[3, 3]]}}]}
complete the first level build	{"dialogue_type": "HUMAN_GIVE_COMMAND", "action_sequence": [{"action_type": "FREEBUILD", "reference_object": {"has_name": [[2, 2], [3, 3], [4, 4]]}}]}
complete the hole by sealing it by filling it with dirt	{"dialogue_type": "HUMAN_GIVE_COMMAND", "action_sequence": [{"action_type": "FILL", "has_block_type": [[10, 10]], "reference_object": {"has_name": [[2, 2]]}}]}
complete the job	{"dialogue_type": "HUMAN_GIVE_COMMAND", "action_sequence": [{"action_type": "FREEBUILD", "reference_object": {"has_name": [[2, 2]]}}]}
complete the mission	{"dialogue_type": "HUMAN_GIVE_COMMAND", "action_sequence": [{"action_type": "FREEBUILD", "reference_object": {"has_name": [[2, 2]]}}]}
complete the task	{"dialogue_type": "HUMAN_GIVE_COMMAND", "action_sequence": [{"action_type": "FREEBUILD", "reference_object": {"has_name": [[2, 2]]}}]}
complete the wall	{"dialogue_type": "HUMAN_GIVE_COMMAND", "action_sequence": [{"action_type": "FREEBUILD", "reference_object": {"has_name": [[2, 2]]}}]}
continue building the base	{"dialogue_type": "HUMAN_GIVE_COMMAND", "action_sequence": [{"action_type": "RESUME", "target_action_type": [[1, 1], [3, 3]]}]}
continue digging	{"dialogue_type": "HUMAN_GIVE_COMMAND", "action_sequence": [{"action_type": "RESUME", "target_action_type": [[1, 1]]}]}
copy my likeness on the door	{"dialogue_type": "HUMAN_GIVE_COMMAND", "action_sequence": [{"action_type": "COPY", "location": {"location_type": "REFERENCE_OBJECT", "reference_object": {"contains_coreference": "no", "has_name": [[5, 5]]}}, "reference_object": {"has_name": [[1, 1], [2, 2]]}}]}
copy other players' valuable moves and abilities	{"dialogue_type": "HUMAN_GIVE_COMMAND", "action_sequence": [{"action_type": "COPY", "reference_object": {"has_name": [[1, 1], [2, 2], [3, 3], [4, 4], [5, 5], [6, 6]]}}]}
copy the colour scheme of the living room	{"dialogue_type": "HUMAN_GIVE_COMMAND", "action_sequence": [{"action_type": "COPY", "reference_object": {"location": {"location_type": "REFERENCE_OBJECT", "reference_object": {"contains_coreference": "no", "has_name": [[6, 6], [7, 7]]}}, "has_name": [[2, 2], [3, 3]]}}]}
copy the information	{"dialogue_type": "HUMAN_GIVE_COMMAND", "action_sequence": [{"action_type": "COPY", "reference_object": {"has_name": [[2, 2]]}}]}
copy the mountain on both sides of the map	{"dialogue_type": "HUMAN_GIVE_COMMAND", "action_sequence": [{"action_type": "COPY", "location": {"location_type": "REFERENCE_OBJECT"}, "reference_object": {"has_name": [[2, 2]]}}]}
copy the red pyramid structure	{"dialogue_type": "HUMAN_GIVE_COMMAND", "action_sequence": [{"action_type": "COPY", "reference_object": {"has_name": [[3, 3], [4, 4]], "has_colour": [[2, 2]]}}]}
copy the shovel	{"dialogue_type": "HUMAN_GIVE_COMMAND", "action_sequence": [{"action_type": "COPY", "reference_object": {"has_name": [[2, 2]]}}]}
copy this block	{"dialogue_type": "HUMAN_GIVE_COMMAND", "action_sequence": [{"action_type": "COPY", "reference_object": {"has_name": [[2, 2]]}}]}
copy this number	{"dialogue_type": "HUMAN_GIVE_COMMAND", "action_sequence": [{"action_type": "COPY", "reference_object": {"contains_coreference": "yes", "has_name": [[1, 1], [2, 2]]}}]}
copy what the other team is doing	{"dialogue_type": "HUMAN_GIVE_COMMAND", "action_sequence": [{"action_type": "COPY", "reference_object": {"has_name": [[1, 1], [3, 3], [4, 4], [5, 5], [6, 6]]}}]}
craft it	{"dialogue_type": "HUMAN_GIVE_COMMAND", "action_sequence": [{"action_type": "BUILD", "schematic": {"has_name": [[1, 1]]}}]}
cut the tree down	{"dialogue_type": "HUMAN_GIVE_COMMAND", "action_sequence": [{"action_type": "DESTROY", "reference_object": {"has_name": [[2, 2]]}}]}
destroy a block next to it	{"dialogue_type": "HUMAN_GIVE_COMMAND", "action_sequence": [{"action_type": "DESTROY", "reference_object": {"location": {"location_type": "REFERENCE_OBJECT", "relative_direction": "NEAR", "reference_object": {"contains_coreference": "yes", "has_name": [[5, 5]]}}, "has_name": [[2, 2]]}}]}
destroy a wall	{"dialogue_type": "HUMAN_GIVE_COMMAND", "action_sequence": [{"action_type": "DESTROY", "reference_object": {"has_name": [[2, 2]]}}]}
destroy all blue blocks	{"dialogue_type": "HUMAN_GIVE_COMMAND", "action_sequence": [{"action_type": "DESTROY", "reference_object": {"has_name": [[3, 3]], "has_colour": [[2, 2]]}, "repeat": {"repeat_key": "ALL"}}]}
destroy building	{"dialogue_type": "HUMAN_GIVE_COMMAND", "action_sequence": [{"action_type": "DESTROY", "reference_object": {"has_name": [[1, 1]]}}]}
destroy closest player	{"dialogue_type": "HUMAN_GIVE_COMMAND", "action_sequence": [{"action_type": "DESTROY", "reference_object": {"has_name": [[1, 1], [2, 2]]}}]}
destroy closest player on landing	{"dialogue_type": "HUMAN_GIVE_COMMAND", "action_sequence": [{"action_type": "DESTROY", "reference_object": {"has_name": [[2, 2]], "has_tag": [[1, 1], [3, 3], [4, 4]]}}]}
destroy enemy tower	{"dialogue_type": "HUMAN_GIVE_COMMAND", "action_sequence": [{"action_type": "DESTROY", "reference_object": {"has_name": [[2, 2]], "has_tag": [[1, 1]]}}]}
destroy his body	{"dialogue_type": "HUMAN_GIVE_COMMAND", "action_sequence": [{"action_type": "DESTROY", "reference_object": {"has_name": [[1, 1], [2, 2]]}}]}
destroy it	{"dialogue_type": "HUMAN_GIVE_COMMAND", "action_sequence": [{"action_type": "DESTROY", "reference_object": {"contains_coreference": "yes"}}]}
destroy that giant rock	{"dialogue_type": "HUMAN_GIVE_COMMAND", "action_sequence": [{"action_type": "DESTROY", "reference_object": {"has_name": [[3, 3]], "has_size": [[2, 2]]}}]}
destroy that opponent	{"dialogue_type": "HUMAN_GIVE_COMMAND", "action_sequence": [{"action_type": "DESTROY", "reference_object": {"has_name": [[2, 2]]}}]}
destroy the box	{"dialogue_type": "HUMAN_GIVE_COMMAND", "action_sequence": [{"action_type": "DESTROY", "reference_object": {"has_name": [[2, 2]]}}]}
destroy the brown door	{"dialogue_type": "HUMAN_GIVE_COMMAND", "action_sequence": [{"action_type": "DESTROY", "reference_object": {"has_name": [[3, 3]], "has_colour": [[2, 2]]}}]}
destroy the building	{"dialogue_type": "HUMAN_GIVE_COMMAND", "action_sequence": [{"action_type": "DESTROY", "reference_object": {"has_name": [[2, 2]]}}]}
destroy the building in front of you	{"dialogue_type": "HUMAN_GIVE_COMMAND", "action_sequence": [{"action_type": "DESTROY", "reference_object": {"location": {"location_type": "AGENT_POS", "relative_direction": "FRONT"}, "has_name": [[2, 2]]}}]}
destroy the building straight ahead	{"dialogue_type": "HUMAN_GIVE_COMMAND", "action_sequence": [{"action_type": "DESTROY", "reference_object": {"location": {"location_type": "AGENT_POS", "relative_direction": "FRONT"}, "has_name": [[2, 2]]}}]}
destroy the cave	{"dialogue_type": "HUMAN_GIVE_COMMAND", "action_sequence": [{"action_type": "DESTROY", "reference_object": {"has_name": [[2, 2]]}}]}
destroy the ceiling	{"dialogue_type": "HUMAN_GIVE_COMMAND", "action_sequence": [{"action_type": "DESTROY", "reference_object": {"has_name": [[2, 2]]}}]}
destroy the door	{"dialogue_type": "HUMAN_GIVE_COMMAND", "action_sequence": [{"action_type": "DESTROY", "reference_object": {"has_name": [[2, 2]]}}]}
destroy the force field created by the ban bot	{"dialogue_type": "HUMAN_GIVE_COMMAND", "action_sequence": [{"action_type": "DESTROY", "reference_object": {"has_name": [[2, 2], [3, 3]], "has_tag": [[4, 4], [5, 5], [7, 7], [8, 8]]}}]}
destroy the house	{"dialogue_type": "HUMAN_GIVE_COMMAND", "action_sequence": [{"action_type": "DESTROY", "reference_object": {"has_name": [[2, 2]]}}]}
destroy the old build	{"dialogue_type": "HUMAN_GIVE_COMMAND", "action_sequence": [{"action_type": "DESTROY", "reference_object": {"has_name": [[3, 3]], "has_tag": [[2, 2]]}}]}
destroy the people	{"dialogue_type": "HUMAN_GIVE_COMMAND", "action_sequence": [{"action_type": "DESTROY", "reference_object": {"has_name": [[2, 2]]}}]}
destroy the purple pyramid	{"dialogue_type": "HUMAN_GIVE_COMMAND", "action_sequence": [{"action_type": "DESTROY", "reference_object": {"has_name": [[3, 3]], "has_colour": [[2, 2]]}}]}
destroy the rocks until they are all one level	{"dialogue_type": "HUMAN_GIVE_COMMAND", "action_sequence": [{"action_type": "DESTROY", "reference_object": {"has_name": [[2, 2]]}, "repeat": {"stop_condition": {"condition_span": [[4, 4], [5, 5], [6, 6], [7, 7], [8, 8]]}}}]}
destroy the tree	{"dialogue_type": "HUMAN_GIVE_COMMAND", "action_sequence": [{"action_type": "DESTROY", "reference_object": {"has_name": [[2, 2]]}}]}
destroy the wall	{"dialogue_type": "HUMAN_GIVE_COMMAND", "action_sequence": [{"action_type": "DESTROY", "reference_object": {"has_name": [[2, 2]]}}]}
destroy the wall above the character	{"dialogue_type": "HUMAN_GIVE_COMMAND", "action_sequence": [{"action_type": "DESTROY", "reference_object": {"location": {"location_type": "REFERENCE_OBJECT", "relative_direction": "UP", "reference_object": {"contains_coreference": "no", "has_name": [[5, 5]]}}, "has_name": [[2, 2]]}}]}
destroy the wall in front of you	{"dialogue_type": "HUMAN_GIVE_COMMAND", "action_sequence": [{"action_type": "DESTROY", "reference_object": {"location": {"location_type": "AGENT_POS", "relative_direction": "FRONT"}, "has_name": [[2, 2]]}}]}
destroy the walls	{"dialogue_type": "HUMAN_GIVE_COMMAND", "action_sequence": [{"action_type": "DESTROY", "reference_object": {"has_name": [[2, 2]]}}]}
destroy the wooden door in front of you	{"dialogue_type": "HUMAN_GIVE_COMMAND", "action_sequence": [{"action_type": "DESTROY", "reference_object": {"location": {"location_type": "AGENT_POS", "relative_direction": "FRONT"}, "has_name": [[3, 3]], "has_block_type": [[2, 2]]}}]}
destroy the wooden support outside the door	{"dialogue_type": "HUMAN_GIVE_COMMAND", "action_sequence": [{"action_type": "DESTROY", "reference_object": {"location": {"location_type": "REFERENCE_OBJECT", "relative_direction": "OUTSIDE", "reference_object": {"contains_coreference": "no", "has_name": [[6, 6]]}}, "has_name": [[3, 3]], "has_block_type": [[2, 2]]}}]}
destroy their base	{"dialogue_type": "HUMAN_GIVE_COMMAND", "action_sequence": [{"action_type": "DESTROY", "reference_object": {"has_name": [[2, 2]]}}]}
destroy this old marbles	{"dialogue_type": "HUMAN_GIVE_COMMAND", "action_sequence": [{"action_type": "DESTROY", "reference_object": {"contains_coreference": "yes", "has_name": [[3, 3]], "has_tag": [[2, 2]]}}]}
destroy this tree	{"dialogue_type": "HUMAN_GIVE_COMMAND", "action_sequence": [{"action_type": "DESTROY", "reference_object": {"has_name": [[2, 2]]}}]}
dig	{"dialogue_type": "HUMAN_GIVE_COMMAND", "action_sequence": [{"action_type": "DIG"}]}
dig a deep hole in the ground	{"dialogue_type": "HUMAN_GIVE_COMMAND", "action_sequence": [{"action_type": "DIG", "location": {"location_type": "REFERENCE_OBJECT", "relative_direction": "INSIDE", "reference_object": {"contains_coreference": "no", "has_name": [[6, 6]]}}, "schematic": {"has_name": [[3, 3]], "has_size": [[2, 2]]}}]}
dig a hole	{"dialogue_type": "HUMAN_GIVE_COMMAND", "action_sequence": [{"action_type": "DIG", "schematic": {"has_name": [[2, 2]]}}]}
dig a hole by that tree	{"dialogue_type": "HUMAN_GIVE_COMMAND", "action_sequence": [{"action_type": "DIG", "location": {"location_type": "REFERENCE_OBJECT", "relative_direction": "NEAR", "reference_object": {"contains_coreference": "no", "has_name": [[4, 4], [5, 5]]}}, "schematic": {"has_name": [[2, 2]]}}]}
dig a hole in the ground	{"dialogue_type": "HUMAN_GIVE_COMMAND", "action_sequence": [{"action_type": "DIG", "location": {"location_type": "REFERENCE_OBJECT", "relative_direction": "INSIDE", "reference_object": {"contains_coreference": "no", "has_name": [[5, 5]]}}, "schematic": {"has_name": [[2, 2]]}}]}
dig a hole three feet by three feet	{"dialogue_type": "HUMAN_GIVE_COMMAND", "action_sequence": [{"action_type": "DIG", "schematic": {"has_name": [[2, 2]], "has_length": [[3, 3]], "has_width": [[6, 6]]}}]}
dig a large hole	{"dialogue_type": "HUMAN_GIVE_COMMAND", "action_sequence": [{"action_type": "DIG", "schematic": {"has_name": [[3, 3]], "has_size": [[2, 2]]}}]}
dig a pit	{"dialogue_type": "HUMAN_GIVE_COMMAND", "action_sequence": [{"action_type": "DIG", "schematic": {"has_name": [[2, 2]]}}]}
dig a slope up for them to get out	{"dialogue_type": "HUMAN_GIVE_COMMAND", "action_sequence": [{"action_type": "DIG", "schematic": {"has_name": [[2, 2]]}}]}
dig a ten by ten hole that is 10 blocks deep	{"dialogue_type": "HUMAN_GIVE_COMMAND", "action_sequence": [{"action_type": "DIG", "schematic": {"has_name": [[5, 5]], "has_length": [[2, 2]], "has_width": [[4, 4]], "has_depth": [[8, 8], [9, 9]]}}]}
dig a tunnel	{"dialogue_type": "HUMAN_GIVE_COMMAND", "action_sequence": [{"action_type": "DIG", "schematic": {"has_name": [[2, 2]]}}]}
dig a tunnel directly to china	{"dialogue_type": "HUMAN_GIVE_COMMAND", "action_sequence": [{"action_type": "DIG", "location": {"location_type": "REFERENCE_OBJECT", "reference_object": {"contains_coreference": "no", "has_name": [[5, 5]]}}, "schematic": {"has_name": [[2, 2]]}}]}
dig a whole	{"dialogue_type": "HUMAN_GIVE_COMMAND", "action_sequence": [{"action_type": "DIG", "schematic": {"has_name": [[2, 2]]}}]}
dig all the herbs nearby	{"dialogue_type": "HUMAN_GIVE_COMMAND", "action_sequence": [{"action_type": "DIG", "location": {"location_type": "AGENT_POS", "relative_direction": "NEAR"}, "schematic": {"has_name": [[3, 3]]}, "repeat": {"repeat_key": "ALL"}}]}
dig an area about 40 x 40	{"dialogue_type": "HUMAN_GIVE_COMMAND", "action_sequence": [{"action_type": "DIG", "schematic": {"has_name": [[2, 2]], "has_length": [[4, 4]], "has_width": [[6, 6]]}}]}
dig around your base	{"dialogue_type": "HUMAN_GIVE_COMMAND", "action_sequence": [{"action_type": "DIG", "location": {"location_type": "REFERENCE_OBJECT", "relative_direction": "AROUND", "reference_object": {"contains_coreference": "no", "has_name": [[2, 2], [3, 3]]}}}]}
dig down to lower level	{"dialogue_type": "HUMAN_GIVE_COMMAND", "action_sequence": [{"action_type": "DIG", "location": {"location_type": "AGENT_POS", "relative_direction": "DOWN"}}]}
dig for iron near the home base	{"dialogue_type": "HUMAN_GIVE_COMMAND", "action_sequence": [{"action_type": "DIG", "location": {"location_type": "REFERENCE_OBJECT", "relative_direction": "NEAR", "reference_object": {"contains_coreference": "no", "has_name": [[5, 5], [6, 6]]}}, "schematic": {"has_name": [[2, 2]]}}]}
dig four trenches	{"dialogue_type": "HUMAN_GIVE_COMMAND", "action_sequence": [{"action_type": "DIG", "schematic": {"has_name": [[2, 2]]}, "repeat": {"repeat_key": "FOR", "repeat_count": [[1, 1]]}}]}
dig me a pond	{"dialogue_type": "HUMAN_GIVE_COMMAND", "action_sequence": [{"action_type": "DIG", "schematic": {"has_name": [[3, 3]]}}]}
dig next to building	{"dialogue_type": "HUMAN_GIVE_COMMAND", "action_sequence": [{"action_type": "DIG", "location": {"location_type": "REFERENCE_OBJECT", "relative_direction": "NEAR", "reference_object": {"contains_coreference": "no", "has_name": [[3, 3]]}}}]}
dig next to that building	{"dialogue_type": "HUMAN_GIVE_COMMAND", "action_sequence": [{"action_type": "DIG", "location": {"location_type": "REFERENCE_OBJECT", "relative_direction": "NEAR", "reference_object": {"contains_coreference": "no", "has_name": [[4, 4]]}}}]}
dig over there	{"dialogue_type": "HUMAN_GIVE_COMMAND", "action_sequence": [{"action_type": "DIG", "location": {"contains_coreference": "yes"}}]}
dig small ditches around the castle	{"dialogue_type": "HUMAN_GIVE_COMMAND", "action_sequence": [{"action_type": "DIG", "location": {"location_type": "REFERENCE_OBJECT", "relative_direction": "AROUND", "reference_object": {"contains_coreference": "no", "has_name": [[5, 5]]}}, "schematic": {"has_name": [[2, 2]], "has_size": [[1, 1]]}}]}
dig underneath you	{"dialogue_type": "HUMAN_GIVE_COMMAND", "action_sequence": [{"action_type": "DIG", "location": {"location_type": "AGENT_POS", "relative_direction": "DOWN"}}]}
dig until you find it	{"dialogue_type": "HUMAN_GIVE_COMMAND", "action_sequence": [{"action_type": "DIG", "repeat": {"stop_condition": {"condition_type": "ADJACENT_TO_BLOCK_TYPE", "block_type": [[1, 1], [2, 2], [3, 3], [4, 4]]}}}]}
dig up a 4 x 4 x 4 hole	{"dialogue_type": "HUMAN_GIVE_COMMAND", "action_sequence": [{"action_type": "DIG", "schematic": {"has_name": [[8, 8]], "has_length": [[3, 3]], "has_width": [[5, 5]], "has_depth": [[7, 7]]}}]}
dig up a flower	{"dialogue_type": "HUMAN_GIVE_COMMAND", "action_sequence": [{"action_type": "DIG", "schematic": {"has_name": [[3, 3]]}}]}
dig up the dirt	{"dialogue_type": "HUMAN_GIVE_COMMAND", "action_sequence": [{"action_type": "DIG", "schematic": {"has_name": [[3, 3]]}}]}
dig up the vegetables	{"dialogue_type": "HUMAN_GIVE_COMMAND", "action_sequence": [{"action_type": "DIG", "schematic": {"has_name": [[3, 3]]}}]}
do a new spawn	{"dialogue_type": "HUMAN_GIVE_COMMAND", "action_sequence": [{"action_type": "SPAWN"}]}
drop that brick	{"dialogue_type": "HUMAN_GIVE_COMMAND", "action_sequence": [{"action_type": "OTHERACTION", "reference_object": {"contains_coreference": "yes", "has_name": [[2, 2]]}}]}
escape	{"dialogue_type": "HUMAN_GIVE_COMMAND", "action_sequence": [{"action_type": "OTHERACTION"}]}
extract item	{"dialogue_type": "HUMAN_GIVE_COMMAND", "action_sequence": [{"action_type": "OTHERACTION", "reference_object": {"has_name": [[1, 1]]}}]}
fill a bucket	{"dialogue_type": "HUMAN_GIVE_COMMAND", "action_sequence": [{"action_type": "FILL", "reference_object": {"has_name": [[2, 2]]}}]}
fill all the beakers with 20 ml of vinegar	{"dialogue_type": "HUMAN_GIVE_COMMAND", "action_sequence": [{"action_type": "FILL", "has_block_type": [[5, 5], [6, 6], [7, 7], [8, 8]], "reference_object": {"has_name": [[3, 3]]}, "repeat": {"repeat_key": "ALL"}}]}
fill an empty bucket	{"dialogue_type": "HUMAN_GIVE_COMMAND", "action_sequence": [{"action_type": "FILL", "reference_object": {"has_name": [[3, 3]], "has_tag": [[2, 2]]}}]}
fill in holes at all entrances to the cave around the perimeter	{"dialogue_type": "HUMAN_GIVE_COMMAND", "action_sequence": [{"action_type": "FILL", "reference_object": {"location": {"location_type": "REFERENCE_OBJECT", "reference_object": {"contains_coreference": "no", "has_name": [[5, 5], [6, 6], [8, 8], [9, 9], [11, 11]]}}, "has_name": [[2, 2]]}, "repeat": {"repeat_key": "ALL"}}]}
fill in the space where you were just standing	{"dialogue_type": "HUMAN_GIVE_COMMAND", "action_sequence": [{"action_type": "FILL", "reference_object": {"location": {"location_type": "AGENT_POS"}, "has_name": [[3, 3]]}}]}
fill it in the lava	{"dialogue_type": "HUMAN_GIVE_COMMAND", "action_sequence": [{"action_type": "FILL", "has_block_type": [[4, 4]], "reference_object": {"contains_coreference": "yes"}}]}
fill it up with lava	{"dialogue_type": "HUMAN_GIVE_COMMAND", "action_sequence": [{"action_type": "FILL", "has_block_type": [[4, 4]], "reference_object": {"contains_coreference": "yes"}}]}
fill it with a different material	{"dialogue_type": "HUMAN_GIVE_COMMAND", "action_sequence": [{"action_type": "FILL", "has_block_type": [[4, 4], [5, 5]], "reference_object": {"contains_coreference": "yes"}}]}
fill it with water	{"dialogue_type": "HUMAN_GIVE_COMMAND", "action_sequence": [{"action_type": "FILL", "has_block_type": [[3, 3]], "reference_object": {"contains_coreference": "yes"}}]}
fill it with water for a pool	{"dialogue_type": "HUMAN_GIVE_COMMAND", "action_sequence": [{"action_type": "FILL", "has_block_type": [[3, 3]], "reference_object": {"contains_coreference": "yes"}}]}
fill the bank with retrieved natural resource	{"dialogue_type": "HUMAN_GIVE_COMMAND", "action_sequence": [{"action_type": "FILL", "has_block_type": [[4, 4], [5, 5], [6, 6]], "reference_object": {"has_name": [[2, 2]]}}]}
fill the cave with sand	{"dialogue_type": "HUMAN_GIVE_COMMAND", "action_sequence": [{"action_type": "FILL", "has_block_type": [[4, 4]], "reference_object": {"has_name": [[2, 2]]}}]}
fill the ditches with rocks	{"dialogue_type": "HUMAN_GIVE_COMMAND", "action_sequence": [{"action_type": "FILL", "has_block_type": [[4, 4]], "reference_object": {"has_name": [[2, 2]]}}]}
fill the hole with cement	{"dialogue_type": "HUMAN_GIVE_COMMAND", "action_sequence": [{"action_type": "FILL", "has_block_type": [[4, 4]], "reference_object": {"has_name": [[2, 2]]}}]}
fill the hole with sand	{"dialogue_type": "HUMAN_GIVE_COMMAND", "action_sequence": [{"action_type": "FILL", "has_block_type": [[4, 4]], "reference_object": {"has_name": [[2, 2]]}}]}
fill the holes with flowers	{"dialogue_type": "HUMAN_GIVE_COMMAND", "action_sequence": [{"action_type": "FILL", "has_block_type": [[4, 4]], "reference_object": {"has_name": [[2, 2]]}}]}
fill the house with water	{"dialogue_type": "HUMAN_GIVE_COMMAND", "action_sequence": [{"action_type": "FILL", "has_block_type": [[4, 4]], "reference_object": {"has_name": [[2, 2]]}}]}
fill the pyramids up with water	{"dialogue_type": "HUMAN_GIVE_COMMAND", "action_sequence": [{"action_type": "FILL", "has_block_type": [[5, 5]], "reference_object": {"has_name": [[2, 2]]}}]}
fill the room with water	{"dialogue_type": "HUMAN_GIVE_COMMAND", "action_sequence": [{"action_type": "FILL", "has_block_type": [[4, 4]], "reference_object": {"has_name": [[2, 2]]}}]}
fill the space where the door was with stone	{"dialogue_type": "HUMAN_GIVE_COMMAND", "action_sequence": [{"action_type": "FILL", "has_block_type": [[8, 8]], "reference_object": {"location": {"location_type": "REFERENCE_OBJECT", "reference_object": {"contains_coreference": "no", "has_name": [[3, 3], [5, 5], [6, 6]]}}, "has_name": [[2, 2]]}}]}
fill the watering can with water	{"dialogue_type": "HUMAN_GIVE_COMMAND", "action_sequence": [{"action_type": "FILL", "has_block_type": [[5, 5]], "reference_object": {"has_name": [[2, 2], [3, 3]]}}]}
fill up the bucket	{"dialogue_type": "HUMAN_GIVE_COMMAND", "action_sequence": [{"action_type": "FILL", "reference_object": {"has_name": [[3, 3]]}}]}
fill up the pool with water	{"dialogue_type": "HUMAN_GIVE_COMMAND", "action_sequence": [{"action_type": "FILL", "has_block_type": [[5, 5]], "reference_object": {"has_name": [[3, 3]]}}]}
fill up the structure of building	{"dialogue_type": "HUMAN_GIVE_COMMAND", "action_sequence": [{"action_type": "FILL", "reference_object": {"has_name": [[3, 3], [4, 4]]}}]}
find a character	{"dialogue_type": "HUMAN_GIVE_COMMAND", "action_sequence": [{"action_type": "OTHERACTION", "reference_object": {"has_name": [[2, 2]]}}]}
find diamonds	{"dialogue_type": "HUMAN_GIVE_COMMAND", "action_sequence": [{"action_type": "OTHERACTION", "reference_object": {"has_name": [[1, 1]]}}]}
find some berries and wheat	{"dialogue_type": "HUMAN_GIVE_COMMAND", "action_sequence": [{"action_type": "OTHERACTION", "reference_object": {"has_name": [[2, 2], [3, 3], [4, 4]]}}]}
find some bricks	{"dialogue_type": "HUMAN_GIVE_COMMAND", "action_sequence": [{"action_type": "OTHERACTION", "reference_object": {"has_name": [[2, 2]]}}]}
find the hidden sword	{"dialogue_type": "HUMAN_GIVE_COMMAND", "action_sequence": [{"action_type": "OTHERACTION", "reference_object": {"has_name": [[2, 2], [3, 3]]}}]}
finish all the other chores	{"dialogue_type": "HUMAN_GIVE_COMMAND", "action_sequence": [{"action_type": "FREEBUILD", "reference_object": {"has_name": [[3, 3], [4, 4]]}, "repeat": {"repeat_key": "ALL"}}]}
flood it with acid	{"dialogue_type": "HUMAN_GIVE_COMMAND", "action_sequence": [{"action_type": "FILL", "has_block_type": [[3, 3]], "reference_object": {"contains_coreference": "yes"}}]}
fly my toon to the marked npc	{"dialogue_type": "HUMAN_GIVE_COMMAND", "action_sequence": [{"action_type": "OTHERACTION", "location": {"location_type": "REFERENCE_OBJECT", "reference_object": {"contains_coreference": "no", "has_name": [[5, 5], [6, 6]]}}, "reference_object": {"has_name": [[1, 1], [2, 2]]}}]}
focus on the customer demands	{"dialogue_type": "HUMAN_GIVE_COMMAND", "action_sequence": [{"action_type": "OTHERACTION", "reference_object": {"has_name": [[3, 3], [4, 4]]}}]}
get 3 string	{"dialogue_type": "HUMAN_GIVE_COMMAND", "action_sequence": [{"action_type": "OTHERACTION", "reference_object": {"has_name": [[2, 2]]}, "repeat": {"repeat_key": "FOR", "repeat_count": [[1, 1]]}}]}
get 3 wood	{"dialogue_type": "HUMAN_GIVE_COMMAND", "action_sequence": [{"action_type": "OTHERACTION", "reference_object": {"has_name": [[2, 2]]}, "repeat": {"repeat_key": "FOR", "repeat_count": [[1, 1]]}}]}
get a hammer	{"dialogue_type": "HUMAN_GIVE_COMMAND", "action_sequence": [{"action_type": "OTHERACTION", "reference_object": {"has_name": [[2, 2]]}}]}
get fence	{"dialogue_type": "HUMAN_GIVE_COMMAND", "action_sequence": [{"action_type": "OTHERACTION", "reference_object": {"has_name": [[1, 1]]}}]}
get out of here	{"dialogue_type": "HUMAN_GIVE_COMMAND", "action_sequence": [{"action_type": "MOVE", "location": {"contains_coreference": "yes"}}]}
get wood	{"dialogue_type": "HUMAN_GIVE_COMMAND", "action_sequence": [{"action_type": "OTHERACTION", "reference_object": {"has_name": [[1, 1]]}}]}
give me the resources from the wall	{"dialogue_type": "HUMAN_GIVE_COMMAND", "action_sequence": [{"action_type": "OTHERACTION", "location": {"location_type": "REFERENCE_OBJECT", "reference_object": {"has_name": [[6, 6]]}}, "reference_object": {"has_name": [[3, 3]]}}]}
go around this building	{"dialogue_type": "HUMAN_GIVE_COMMAND", "action_sequence": [{"action_type": "MOVE", "location": {"location_type": "REFERENCE_OBJECT", "relative_direction": "AROUND", "reference_object": {"contains_coreference": "no", "has_name": [[3, 3]]}}}]}
go deep into the cave	{"dialogue_type": "HUMAN_GIVE_COMMAND", "action_sequence": [{"action_type": "MOVE", "location": {"location_type": "REFERENCE_OBJECT", "relative_direction": "INSIDE", "reference_object": {"contains_coreference": "no", "has_name": [[4, 4]]}}}]}
go get a lava bucket	{"dialogue_type": "HUMAN_GIVE_COMMAND", "action_sequence": [{"action_type": "OTHERACTION", "reference_object": {"has_name": [[4, 4]], "has_block_type": [[3, 3]]}}]}
go get some stone	{"dialogue_type": "HUMAN_GIVE_COMMAND", "action_sequence": [{"action_type": "OTHERACTION", "reference_object": {"has_name": [[3, 3]]}}]}
go in the house	{"dialogue_type": "HUMAN_GIVE_COMMAND", "action_sequence": [{"action_type": "MOVE", "location": {"location_type": "REFERENCE_OBJECT", "relative_direction": "INSIDE", "reference_object": {"contains_coreference": "no", "has_name": [[3, 3]]}}}]}
go into the room on the left	{"dialogue_type": "HUMAN_GIVE_COMMAND", "action_sequence": [{"action_type": "MOVE", "location": {"location_type": "REFERENCE_OBJECT", "relative_direction": "INSIDE", "reference_object": {"contains_coreference": "no", "has_name": [[3, 3], [4, 4], [6, 6]]}}}]}
go into the store	{"dialogue_type": "HUMAN_GIVE_COMMAND", "action_sequence": [{"action_type": "MOVE", "location": {"location_type": "REFERENCE_OBJECT", "relative_direction": "INSIDE", "reference_object": {"contains_coreference": "no", "has_name": [[3, 3]]}}}]}
go open the door	{"dialogue_type": "HUMAN_GIVE_COMMAND", "action_sequence": [{"action_type": "OTHERACTION", "reference_object": {"has_name": [[3, 3]]}}]}
go outside	{"dialogue_type": "HUMAN_GIVE_COMMAND", "action_sequence": [{"action_type": "MOVE", "location": {"location_type": "REFERENCE_OBJECT", "relative_direction": "OUTSIDE", "reference_object": {"contains_coreference": "no"}}}]}
go straight	{"dialogue_type": "HUMAN_GIVE_COMMAND", "action_sequence": [{"action_type": "MOVE", "location": {"location_type": "AGENT_POS", "relative_direction": "FRONT"}}]}
go to the beach	{"dialogue_type": "HUMAN_GIVE_COMMAND", "action_sequence": [{"action_type": "MOVE", "location": {"location_type": "REFERENCE_OBJECT", "reference_object": {"contains_coreference": "no", "has_name": [[3, 3]]}}}]}
go to the castle	{"dialogue_type": "HUMAN_GIVE_COMMAND", "action_sequence": [{"action_type": "MOVE", "location": {"location_type": "REFERENCE_OBJECT", "reference_object": {"contains_coreference": "no", "has_name": [[3, 3]]}}}]}
go to the door on your left	{"dialogue_type": "HUMAN_GIVE_COMMAND", "action_sequence": [{"action_type": "MOVE", "location": {"location_type": "REFERENCE_OBJECT", "reference_object": {"contains_coreference": "no", "has_name": [[3, 3], [4, 4], [5, 5], [6, 6]]}}}]}
go to the garden	{"dialogue_type": "HUMAN_GIVE_COMMAND", "action_sequence": [{"action_type": "MOVE", "location": {"location_type": "REFERENCE_OBJECT", "reference_object": {"contains_coreference": "no", "has_name": [[3, 3]]}}}]}
go to the general store	{"dialogue_type": "HUMAN_GIVE_COMMAND", "action_sequence": [{"action_type": "MOVE", "location": {"location_type": "REFERENCE_OBJECT", "reference_object": {"contains_coreference": "no", "has_name": [[3, 3], [4, 4]]}}}]}
go to the roof	{"dialogue_type": "HUMAN_GIVE_COMMAND", "action_sequence": [{"action_type": "MOVE", "location": {"location_type": "REFERENCE_OBJECT", "reference_object": {"contains_coreference": "no", "has_name": [[3, 3]]}}}]}
go to the wall in front of you	{"dialogue_type": "HUMAN_GIVE_COMMAND", "action_sequence": [{"action_type": "MOVE", "location": {"location_type": "REFERENCE_OBJECT", "reference_object": {"has_name": [[3, 3]], "location": {"location_type": "AGENT_POS", "relative_direction": "FRONT"}}}}]}
go to the window	{"dialogue_type": "HUMAN_GIVE_COMMAND", "action_sequence": [{"action_type": "MOVE", "location": {"location_type": "REFERENCE_OBJECT", "reference_object": {"contains_coreference": "no", "has_name": [[3, 3]]}}}]}
go up to the house with a blue roof	{"dialogue_type": "HUMAN_GIVE_COMMAND", "action_sequence": [{"action_type": "MOVE", "location": {"location_type": "REFERENCE_OBJECT", "reference_object": {"contains_coreference": "no", "has_name": [[4, 4], [5, 5], [7, 7], [8, 8]]}}}]}
grab 5 yellow flowers	{"dialogue_type": "HUMAN_GIVE_COMMAND", "action_sequence": [{"action_type": "OTHERACTION", "reference_object": {"has_name": [[3, 3]], "has_colour": [[2, 2]]}, "repeat": {"repeat_key": "FOR", "repeat_count": [[1, 1]]}}]}
grab 6 red flowers	{"dialogue_type": "HUMAN_GIVE_COMMAND", "action_sequence": [{"action_type": "OTHERACTION", "reference_object": {"has_name": [[3, 3]], "has_colour": [[2, 2]]}, "repeat": {"repeat_key": "FOR", "repeat_count": [[1, 1]]}}]}
hello please dig a whole 5 times	{"dialogue_type": "HUMAN_GIVE_COMMAND", "action_sequence": [{"action_type": "DIG", "schematic": {"has_name": [[4, 4]]}, "repeat": {"repeat_key": "FOR", "repeat_count": [[5, 5]]}}]}
hello please fill in each hole	{"dialogue_type": "HUMAN_GIVE_COMMAND", "action_sequence": [{"action_type": "FILL", "reference_object": {}, "repeat": {"repeat_key": "ALL"}}]}
help me build a fence around the tree	{"dialogue_type": "HUMAN_GIVE_COMMAND", "action_sequence": [{"action_type": "BUILD", "location": {"location_type": "REFERENCE_OBJECT", "relative_direction": "AROUND", "reference_object": {"contains_coreference": "no", "has_name": [[7, 7]]}}, "schematic": {"has_name": [[4, 4]]}}]}
hey bot destroy the pyramid in front of you	{"dialogue_type": "HUMAN_GIVE_COMMAND", "action_sequence": [{"action_type": "DESTROY", "reference_object": {"location": {"location_type": "AGENT_POS", "relative_direction": "FRONT"}, "has_name": [[4, 4]]}}]}
jump down to the first level	{"dialogue_type": "HUMAN_GIVE_COMMAND", "action_sequence": [{"action_type": "MOVE", "location": {"location_type": "REFERENCE_OBJECT", "reference_object": {"contains_coreference": "no", "has_name": [[4, 4], [5, 5]]}}}]}
jump off of roof	{"dialogue_type": "HUMAN_GIVE_COMMAND", "action_sequence": [{"action_type": "OTHERACTION", "location": {"location_type": "REFERENCE_OBJECT", "relative_direction": "AWAY", "reference_object": {"contains_coreference": "no", "has_name": [[3, 3]]}}, "reference_object": {"has_name": [[0, 0]]}}]}
jump through the window	{"dialogue_type": "HUMAN_GIVE_COMMAND", "action_sequence": [{"action_type": "MOVE", "location": {"location_type": "REFERENCE_OBJECT"}}]}
kill the nearby enemy	{"dialogue_type": "HUMAN_GIVE_COMMAND", "action_sequence": [{"action_type": "DESTROY", "reference_object": {"location": {"location_type": "AGENT_POS", "relative_direction": "NEAR"}, "has_name": [[3, 3]]}}]}
knock on the door to see if anyone is home	{"dialogue_type": "HUMAN_GIVE_COMMAND", "action_sequence": [{"action_type": "OTHERACTION", "reference_object": {"has_name": [[3, 3]]}}]}
light a torch	{"dialogue_type": "HUMAN_GIVE_COMMAND", "action_sequence": [{"action_type": "OTHERACTION", "reference_object": {"has_name": [[2, 2]]}}]}
look around	{"dialogue_type": "HUMAN_GIVE_COMMAND", "action_sequence": [{"action_type": "OTHERACTION", "location": {"location_type": "REFERENCE_OBJECT", "relative_direction": "AROUND"}}]}
look around at top of the hill	{"dialogue_type": "HUMAN_GIVE_COMMAND", "action_sequence": [{"action_type": "OTHERACTION", "location": {"location_type": "REFERENCE_OBJECT"}}]}
look at my agenda	{"dialogue_type": "HUMAN_GIVE_COMMAND", "action_sequence": [{"action_type": "OTHERACTION", "reference_object": {"has_name": [[2, 2], [3, 3]]}}]}
make a copy of every item inside it or on the walls	{"dialogue_type": "HUMAN_GIVE_COMMAND", "action_sequence": [{"action_type": "COPY", "reference_object": {"location": {"location_type": "REFERENCE_OBJECT", "relative_direction": "INSIDE", "reference_object": {"contains_coreference": "yes"}}, "has_name": [[5, 5]]}, "repeat": {"repeat_key": "ALL"}}]}
make a tower	{"dialogue_type": "HUMAN_GIVE_COMMAND", "action_sequence": [{"action_type": "BUILD", "schematic": {"has_name": [[2, 2]]}}]}
make copy of dark gray bricks	{"dialogue_type": "HUMAN_GIVE_COMMAND", "action_sequence": [{"action_type": "COPY", "reference_object": {"has_name": [[5, 5]], "has_colour": [[3, 3], [4, 4]]}}]}
make the other tower turquoise	{"dialogue_type": "HUMAN_GIVE_COMMAND", "action_sequence": [{"action_type": "OTHERACTION", "reference_object": {"has_name": [[2, 2], [3, 3]]}}]}
mine ore	{"dialogue_type": "HUMAN_GIVE_COMMAND", "action_sequence": [{"action_type": "OTHERACTION", "reference_object": {"has_name": [[1, 1]]}}]}
move	{"dialogue_type": "HUMAN_GIVE_COMMAND", "action_sequence": [{"action_type": "MOVE"}]}
move 50 feet	{"dialogue_type": "HUMAN_GIVE_COMMAND", "action_sequence": [{"action_type": "MOVE", "location": {"steps": [[1, 1]]}}]}
move across the room	{"dialogue_type": "HUMAN_GIVE_COMMAND", "action_sequence": [{"action_type": "MOVE", "location": {"location_type": "REFERENCE_OBJECT"}}]}
move around	{"dialogue_type": "HUMAN_GIVE_COMMAND", "action_sequence": [{"action_type": "MOVE", "location": {"location_type": "AGENT_POS", "relative_direction": "AROUND"}}]}
move around the four sided pyramid on your left	{"dialogue_type": "HUMAN_GIVE_COMMAND", "action_sequence": [{"action_type": "MOVE", "location": {"location_type": "REFERENCE_OBJECT", "relative_direction": "AROUND", "reference_object": {"contains_coreference": "no", "has_name": [[3, 3], [4, 4], [5, 5], [6, 6], [7, 7], [8, 8]]}}}]}
move back to where you were	{"dialogue_type": "HUMAN_GIVE_COMMAND", "action_sequence": [{"action_type": "MOVE", "location": {"location_type": "AGENT_POS"}}]}
move before they see you	{"dialogue_type": "HUMAN_GIVE_COMMAND", "action_sequence": [{"action_type": "MOVE"}]}
move behind that person	{"dialogue_type": "HUMAN_GIVE_COMMAND", "action_sequence": [{"action_type": "MOVE", "location": {"location_type": "REFERENCE_OBJECT", "relative_direction": "BACK", "reference_object": {"contains_coreference": "no", "has_name": [[3, 3]]}}}]}
move behind the tree	{"dialogue_type": "HUMAN_GIVE_COMMAND", "action_sequence": [{"action_type": "MOVE", "location": {"location_type": "REFERENCE_OBJECT", "relative_direction": "BACK", "reference_object": {"contains_coreference": "no", "has_name": [[3, 3]]}}}]}
move forward	{"dialogue_type": "HUMAN_GIVE_COMMAND", "action_sequence": [{"action_type": "MOVE", "location": {"location_type": "AGENT_POS", "relative_direction": "FRONT"}}]}
move forward til you come to another room	{"dialogue_type": "HUMAN_GIVE_COMMAND", "action_sequence": [{"action_type": "MOVE", "location": {"location_type": "AGENT_POS", "relative_direction": "FRONT"}, "repeat": {"stop_condition": {"condition_type": "ADJACENT_TO_BLOCK_TYPE", "block_type": [[2, 2], [3, 3], [4, 4], [5, 5], [6, 6], [7, 7]]}}}]}
move into the hole	{"dialogue_type": "HUMAN_GIVE_COMMAND", "action_sequence": [{"action_type": "MOVE", "location": {"location_type": "REFERENCE_OBJECT", "relative_direction": "INSIDE", "reference_object": {"contains_coreference": "no", "has_name": [[3, 3]]}}}]}
move iron to the forge	{"dialogue_type": "HUMAN_GIVE_COMMAND", "action_sequence": [{"action_type": "OTHERACTION", "location": {"location_type": "REFERENCE_OBJECT", "reference_object": {"contains_coreference": "no", "has_name": [[4, 4]]}}, "reference_object": {"has_name": [[1, 1]]}}]}
move left	{"dialogue_type": "HUMAN_GIVE_COMMAND", "action_sequence": [{"action_type": "MOVE", "location": {"location_type": "AGENT_POS", "relative_direction": "LEFT"}}]}
move left until you reach the box	{"dialogue_type": "HUMAN_GIVE_COMMAND", "action_sequence": [{"action_type": "MOVE", "location": {"location_type": "AGENT_POS", "relative_direction": "LEFT"}, "repeat": {"stop_condition": {"condition_type": "ADJACENT_TO_BLOCK_TYPE", "block_type": [[2, 2], [3, 3], [4, 4], [6, 6]]}}}]}
move off it	{"dialogue_type": "HUMAN_GIVE_COMMAND", "action_sequence": [{"action_type": "MOVE", "location": {"location_type": "REFERENCE_OBJECT", "relative_direction": "AWAY", "reference_object": {"contains_coreference": "yes"}}}]}
move on right side where you have incomplete building	{"dialogue_type": "HUMAN_GIVE_COMMAND", "action_sequence": [{"action_type": "MOVE", "location": {"location_type": "REFERENCE_OBJECT", "relative_direction": "RIGHT", "reference_object": {"contains_coreference": "no", "has_name": [[4, 4]]}}}]}
move over one	{"dialogue_type": "HUMAN_GIVE_COMMAND", "action_sequence": [{"action_type": "MOVE", "location": {"location_type": "AGENT_POS", "steps": [[2, 2]]}}]}
move over to the building	{"dialogue_type": "HUMAN_GIVE_COMMAND", "action_sequence": [{"action_type": "MOVE", "location": {"location_type": "REFERENCE_OBJECT", "relative_direction": "NEAR", "reference_object": {"contains_coreference": "no", "has_name": [[4, 4]]}}}]}
move straight ahead	{"dialogue_type": "HUMAN_GIVE_COMMAND", "action_sequence": [{"action_type": "MOVE", "location": {"location_type": "AGENT_POS", "relative_direction": "FRONT"}}]}
move the blocks	{"dialogue_type": "HUMAN_GIVE_COMMAND", "action_sequence": [{"action_type": "OTHERACTION", "reference_object": {"has_name": [[2, 2]]}}]}
move the boxes over here	{"dialogue_type": "HUMAN_GIVE_COMMAND", "action_sequence": [{"action_type": "OTHERACTION", "location": {"contains_coreference": "yes"}, "reference_object": {"has_name": [[2, 2]]}}]}
move the chair from the corner	{"dialogue_type": "HUMAN_GIVE_COMMAND", "action_sequence": [{"action_type": "OTHERACTION", "location": {"location_type": "REFERENCE_OBJECT", "reference_object": {"contains_coreference": "no", "has_name": [[5, 5]]}}, "reference_object": {"has_name": [[2, 2]]}}]}
move the cursor to the exit icon in the program	{"dialogue_type": "HUMAN_GIVE_COMMAND", "action_sequence": [{"action_type": "OTHERACTION", "location": {"location_type": "REFERENCE_OBJECT", "reference_object": {"contains_coreference": "no", "has_name": [[5, 5], [6, 6], [7, 7]]}}, "reference_object": {"has_name": [[2, 2]]}}]}
move the growlights to the north corner of the room	{"dialogue_type": "HUMAN_GIVE_COMMAND", "action_sequence": [{"action_type": "OTHERACTION", "location": {"location_type": "REFERENCE_OBJECT", "reference_object": {"contains_coreference": "no", "has_name": [[5, 5], [6, 6], [7, 7]]}}, "reference_object": {"has_name": [[2, 2]]}}]}
move the receptacle to the street	{"dialogue_type": "HUMAN_GIVE_COMMAND", "action_sequence": [{"action_type": "OTHERACTION", "location": {"location_type": "REFERENCE_OBJECT", "reference_object": {"contains_coreference": "no", "has_name": [[5, 5]]}}, "reference_object": {"has_name": [[2, 2]]}}]}
move the skunk	{"dialogue_type": "HUMAN_GIVE_COMMAND", "action_sequence": [{"action_type": "OTHERACTION", "reference_object": {"has_name": [[2, 2]]}}]}
move the trash to the main receptacle outside	{"dialogue_type": "HUMAN_GIVE_COMMAND", "action_sequence": [{"action_type": "OTHERACTION", "location": {"location_type": "REFERENCE_OBJECT", "relative_direction": "OUTSIDE", "reference_object": {"contains_coreference": "no"}}, "reference_object": {"has_name": [[2, 2]]}}]}
move the trees to the top of the mountain	{"dialogue_type": "HUMAN_GIVE_COMMAND", "action_sequence": [{"action_type": "OTHERACTION", "location": {"location_type": "REFERENCE_OBJECT", "relative_direction": "UP", "reference_object": {"contains_coreference": "no", "has_name": [[8, 8]]}}, "reference_object": {"has_name": [[2, 2]]}}]}
move these wood blocks over to the clearing	{"dialogue_type": "HUMAN_GIVE_COMMAND", "action_sequence": [{"action_type": "OTHERACTION", "location": {"location_type": "REFERENCE_OBJECT", "reference_object": {"contains_coreference": "no", "has_name": [[7, 7]]}}, "reference_object": {"contains_coreference": "yes", "has_name": [[3, 3]], "has_block_type": [[2, 2]]}}]}
move though the door to the right	{"dialogue_type": "HUMAN_GIVE_COMMAND", "action_sequence": [{"action_type": "MOVE", "location": {"location_type": "AGENT_POS", "relative_direction": "RIGHT"}}]}
move through the doors	{"dialogue_type": "HUMAN_GIVE_COMMAND", "action_sequence": [{"action_type": "MOVE", "location": {"location_type": "REFERENCE_OBJECT"}}]}
move to a cleaning	{"dialogue_type": "HUMAN_GIVE_COMMAND", "action_sequence": [{"action_type": "MOVE", "location": {"location_type": "REFERENCE_OBJECT", "reference_object": {"contains_coreference": "no", "has_name": [[3, 3]]}}}]}
move to a rock	{"dialogue_type": "HUMAN_GIVE_COMMAND", "action_sequence": [{"action_type": "MOVE", "location": {"location_type": "REFERENCE_OBJECT", "reference_object": {"contains_coreference": "no", "has_name": [[3, 3]]}}}]}
move to closest player	{"dialogue_type": "HUMAN_GIVE_COMMAND", "action_sequence": [{"action_type": "MOVE", "location": {"location_type": "REFERENCE_OBJECT", "relative_direction": "NEAR", "reference_object": {"contains_coreference": "no", "has_name": [[2, 2], [3, 3]]}}}]}
move to filling pond	{"dialogue_type": "HUMAN_GIVE_COMMAND", "action_sequence": [{"action_type": "MOVE", "location": {"location_type": "REFERENCE_OBJECT", "reference_object": {"contains_coreference": "no", "has_name": [[2, 2], [3, 3]]}}}]}
move to me	{"dialogue_type": "HUMAN_GIVE_COMMAND", "action_sequence": [{"action_type": "MOVE", "location": {"location_type": "SPEAKER_POS"}}]}
move to the backyard	{"dialogue_type": "HUMAN_GIVE_COMMAND", "action_sequence": [{"action_type": "MOVE", "location": {"location_type": "REFERENCE_OBJECT", "reference_object": {"contains_coreference": "no", "has_name": [[3, 3]]}}}]}
move to the door	{"dialogue_type": "HUMAN_GIVE_COMMAND", "action_sequence": [{"action_type": "MOVE", "location": {"location_type": "REFERENCE_OBJECT", "reference_object": {"contains_coreference": "no", "has_name": [[3, 3]]}}}]}
move to the door on your right	{"dialogue_type": "HUMAN_GIVE_COMMAND", "action_sequence": [{"action_type": "MOVE", "location": {"location_type": "REFERENCE_OBJECT", "reference_object": {"contains_coreference": "no", "has_name": [[3, 3], [4, 4], [5, 5], [6, 6]]}}}]}
move to the kitchen	{"dialogue_type": "HUMAN_GIVE_COMMAND", "action_sequence": [{"action_type": "MOVE", "location": {"location_type": "REFERENCE_OBJECT", "reference_object": {"contains_coreference": "no", "has_name": [[3, 3]]}}}]}
move to the left	{"dialogue_type": "HUMAN_GIVE_COMMAND", "action_sequence": [{"action_type": "MOVE", "location": {"location_type": "AGENT_POS", "relative_direction": "LEFT"}}]}
move to the lighthouse	{"dialogue_type": "HUMAN_GIVE_COMMAND", "action_sequence": [{"action_type": "MOVE", "location": {"location_type": "REFERENCE_OBJECT", "reference_object": {"contains_coreference": "no", "has_name": [[3, 3]]}}}]}
move to the living room	{"dialogue_type": "HUMAN_GIVE_COMMAND", "action_sequence": [{"action_type": "MOVE", "location": {"location_type": "REFERENCE_OBJECT", "reference_object": {"contains_coreference": "no", "has_name": [[3, 3], [4, 4]]}}}]}
move to the north	{"dialogue_type": "HUMAN_GIVE_COMMAND", "action_sequence": [{"action_type": "MOVE", "location": {"location_type": "REFERENCE_OBJECT", "relative_direction": "UP", "reference_object": {"contains_coreference": "no"}}}]}
move to the red building	{"dialogue_type": "HUMAN_GIVE_COMMAND", "action_sequence": [{"action_type": "MOVE", "location": {"location_type": "REFERENCE_OBJECT", "reference_object": {"contains_coreference": "no", "has_name": [[3, 3], [4, 4]]}}}]}
move to the telephone pole	{"dialogue_type": "HUMAN_GIVE_COMMAND", "action_sequence": [{"action_type": "MOVE", "location": {"location_type": "REFERENCE_OBJECT", "relative_direction": "NEAR", "reference_object": {"contains_coreference": "no", "has_name": [[3, 3], [4, 4]]}}}]}
move to the top of the hill	{"dialogue_type": "HUMAN_GIVE_COMMAND", "action_sequence": [{"action_type": "MOVE", "location": {"location_type": "REFERENCE_OBJECT", "reference_object": {"contains_coreference": "no", "has_name": [[3, 3], [4, 4], [6, 6]]}}}]}
move to the top of the hole	{"dialogue_type": "HUMAN_GIVE_COMMAND", "action_sequence": [{"action_type": "MOVE", "location": {"location_type": "REFERENCE_OBJECT", "relative_direction": "UP", "reference_object": {"contains_coreference": "no", "has_name": [[6, 6]]}}}]}
move to the top of the pyramid	{"dialogue_type": "HUMAN_GIVE_COMMAND", "action_sequence": [{"action_type": "MOVE", "location": {"location_type": "REFERENCE_OBJECT", "reference_object": {"contains_coreference": "no", "has_name": [[3, 3], [4, 4], [6, 6]]}}}]}
move to the top of the steps	{"dialogue_type": "HUMAN_GIVE_COMMAND", "action_sequence": [{"action_type": "MOVE", "location": {"location_type": "REFERENCE_OBJECT", "reference_object": {"contains_coreference": "no", "has_name": [[3, 3], [4, 4], [6, 6]]}}}]}
move to your right	{"dialogue_type": "HUMAN_GIVE_COMMAND", "action_sequence": [{"action_type": "MOVE", "location": {"location_type": "AGENT_POS", "relative_direction": "RIGHT"}}]}
move toward the door	{"dialogue_type": "HUMAN_GIVE_COMMAND", "action_sequence": [{"action_type": "MOVE", "location": {"location_type": "REFERENCE_OBJECT"}}]}
move towards bot.0040414.63	{"dialogue_type": "HUMAN_GIVE_COMMAND", "action_sequence": [{"action_type": "MOVE", "location": {"location_type": "REFERENCE_OBJECT"}}]}
move towards door	{"dialogue_type": "HUMAN_GIVE_COMMAND", "action_sequence": [{"action_type": "MOVE", "location": {"location_type": "REFERENCE_OBJECT"}}]}
move towards floors	{"dialogue_type": "HUMAN_GIVE_COMMAND", "action_sequence": [{"action_type": "MOVE", "location": {"location_type": "REFERENCE_OBJECT", "relative_direction": "NEAR", "reference_object": {"contains_coreference": "no", "has_name": [[2, 2]]}}}]}
move towards right	{"dialogue_type": "HUMAN_GIVE_COMMAND", "action_sequence": [{"action_type": "MOVE", "location": {"location_type": "AGENT_POS", "relative_direction": "RIGHT"}}]}
move towards the door	{"dialogue_type": "HUMAN_GIVE_COMMAND", "action_sequence": [{"action_type": "MOVE", "location": {"location_type": "REFERENCE_OBJECT"}}]}
move towards the tree	{"dialogue_type": "HUMAN_GIVE_COMMAND", "action_sequence": [{"action_type": "MOVE", "location": {"location_type": "REFERENCE_OBJECT"}}]}
move up	{"dialogue_type": "HUMAN_GIVE_COMMAND", "action_sequence": [{"action_type": "MOVE", "location": {"location_type": "AGENT_POS", "relative_direction": "UP"}}]}
move up 4 steps	{"dialogue_type": "HUMAN_GIVE_COMMAND", "action_sequence": [{"action_type": "MOVE", "location": {"location_type": "AGENT_POS", "relative_direction": "UP", "steps": [[2, 2]]}, "repeat": {"repeat_key": "FOR", "repeat_count": [[2, 2]], "repeat_dir": "UP"}}]}
move up the pyramid	{"dialogue_type": "HUMAN_GIVE_COMMAND", "action_sequence": [{"action_type": "MOVE", "location": {"location_type": "REFERENCE_OBJECT", "relative_direction": "UP", "reference_object": {"contains_coreference": "no", "has_name": [[3, 3]]}}}]}
now click	{"dialogue_type": "HUMAN_GIVE_COMMAND", "action_sequence": [{"action_type": "OTHERACTION"}]}
observe player in the distance	{"dialogue_type": "HUMAN_GIVE_COMMAND", "action_sequence": [{"action_type": "OTHERACTION", "location": {"location_type": "REFERENCE_OBJECT", "reference_object": {"contains_coreference": "no", "has_name": [[4, 4]]}}, "reference_object": {"has_name": [[1, 1]]}}]}
open the door	{"dialogue_type": "HUMAN_GIVE_COMMAND", "action_sequence": [{"action_type": "OTHERACTION", "reference_object": {"has_name": [[2, 2]]}}]}
paste the information into the field	{"dialogue_type": "HUMAN_GIVE_COMMAND", "action_sequence": [{"action_type": "OTHERACTION", "location": {"location_type": "REFERENCE_OBJECT", "relative_direction": "INSIDE", "reference_object": {"contains_coreference": "no", "has_name": [[5, 5]]}}, "reference_object": {"has_name": [[2, 2]]}}]}
pick it up	{"dialogue_type": "HUMAN_GIVE_COMMAND", "action_sequence": [{"action_type": "OTHERACTION", "reference_object": {"contains_coreference": "yes"}}]}
pick some flowers outside the door	{"dialogue_type": "HUMAN_GIVE_COMMAND", "action_sequence": [{"action_type": "OTHERACTION", "location": {"location_type": "REFERENCE_OBJECT", "relative_direction": "OUTSIDE", "reference_object": {"contains_coreference": "no"}}, "reference_object": {"has_name": [[2, 2]]}}]}
pick up the box	{"dialogue_type": "HUMAN_GIVE_COMMAND", "action_sequence": [{"action_type": "OTHERACTION", "reference_object": {"has_name": [[3, 3]]}}]}
pick up the boxes	{"dialogue_type": "HUMAN_GIVE_COMMAND", "action_sequence": [{"action_type": "OTHERACTION", "reference_object": {"has_name": [[3, 3]]}}]}
pick up the wood	{"dialogue_type": "HUMAN_GIVE_COMMAND", "action_sequence": [{"action_type": "OTHERACTION", "reference_object": {"has_name": [[3, 3]]}}]}
place a bed	{"dialogue_type": "HUMAN_GIVE_COMMAND", "action_sequence": [{"action_type": "SPAWN", "reference_object": {"has_name": [[2, 2]]}}]}
place a crafting table	{"dialogue_type": "HUMAN_GIVE_COMMAND", "action_sequence": [{"action_type": "SPAWN", "reference_object": {"has_name": [[2, 2], [3, 3]]}}]}
place a furn	{"dialogue_type": "HUMAN_GIVE_COMMAND", "action_sequence": [{"action_type": "SPAWN", "reference_object": {"has_name": [[2, 2]]}}]}
place block	{"dialogue_type": "HUMAN_GIVE_COMMAND", "action_sequence": [{"action_type": "SPAWN", "reference_object": {"has_name": [[1, 1]]}}]}
place box in the other room	{"dialogue_type": "HUMAN_GIVE_COMMAND", "action_sequence": [{"action_type": "SPAWN", "location": {"location_type": "REFERENCE_OBJECT", "relative_direction": "INSIDE", "reference_object": {"contains_coreference": "no", "has_name": [[4, 4], [5, 5]]}}, "reference_object": {"has_name": [[1, 1]]}}]}
place it right next to it on the right	{"dialogue_type": "HUMAN_GIVE_COMMAND", "action_sequence": [{"action_type": "SPAWN", "location": {"location_type": "REFERENCE_OBJECT", "relative_direction": "NEAR", "reference_object": {"contains_coreference": "yes"}}, "reference_object": {"contains_coreference": "yes"}}]}
plant some trees	{"dialogue_type": "HUMAN_GIVE_COMMAND", "action_sequence": [{"action_type": "OTHERACTION", "reference_object": {"has_name": [[2, 2]]}}]}
please burn paper in fireplace	{"dialogue_type": "HUMAN_GIVE_COMMAND", "action_sequence": [{"action_type": "OTHERACTION", "location": {"location_type": "REFERENCE_OBJECT", "relative_direction": "INSIDE", "reference_object": {"contains_coreference": "no", "has_name": [[4, 4]]}}, "reference_object": {"location": {"location_type": "REFERENCE_OBJECT", "relative_direction": "INSIDE", "reference_object": {"contains_coreference": "no", "has_name": [[4, 4]]}}, "has_name": [[2, 2]]}}]}
please fill up my tea kettle	{"dialogue_type": "HUMAN_GIVE_COMMAND", "action_sequence": [{"action_type": "FILL", "reference_object": {"has_name": [[3, 3], [4, 4]]}}]}
please move around the room	{"dialogue_type": "HUMAN_GIVE_COMMAND", "action_sequence": [{"action_type": "MOVE", "location": {"location_type": "REFERENCE_OBJECT", "relative_direction": "AROUND", "reference_object": {"contains_coreference": "no", "has_name": [[4, 4]]}}}]}
please move forward	{"dialogue_type": "HUMAN_GIVE_COMMAND", "action_sequence": [{"action_type": "MOVE", "location": {"location_type": "AGENT_POS", "relative_direction": "FRONT"}}]}
please open the door	{"dialogue_type": "HUMAN_GIVE_COMMAND", "action_sequence": [{"action_type": "OTHERACTION", "reference_object": {"has_name": [[3, 3]]}}]}
please stop construction on the wall	{"dialogue_type": "HUMAN_GIVE_COMMAND", "action_sequence": [{"action_type": "STOP", "target_action_type": [[2, 2], [3, 3], [5, 5]]}]}
please stop what you are doing	{"dialogue_type": "HUMAN_GIVE_COMMAND", "action_sequence": [{"action_type": "STOP", "target_action_type": [[2, 2], [3, 3], [4, 4], [5, 5]]}]}
pour water on the plants in front of the house	{"dialogue_type": "HUMAN_GIVE_COMMAND", "action_sequence": [{"action_type": "OTHERACTION", "location": {"location_type": "REFERENCE_OBJECT", "reference_object": {"contains_coreference": "no", "has_name": [[2, 2], [4, 4], [5, 5], [6, 6], [7, 7]]}}, "reference_object": {"has_name": [[1, 1]]}}]}
put a tag on this room	{"dialogue_type": "PUT_MEMORY", "action_sequence": [{"action_type": "TAG", "filters": {"reference_object": {"contains_coreference": "yes", "has_name": [[5, 5]]}}}]}
put empty water bottles into dustbin	{"dialogue_type": "HUMAN_GIVE_COMMAND", "action_sequence": [{"action_type": "FILL", "has_block_type": [[1, 1], [2, 2], [3, 3]], "reference_object": {}}]}
put ladders down	{"dialogue_type": "HUMAN_GIVE_COMMAND", "action_sequence": [{"action_type": "OTHERACTION", "reference_object": {"has_name": [[1, 1]]}}]}
put object down	{"dialogue_type": "HUMAN_GIVE_COMMAND", "action_sequence": [{"action_type": "OTHERACTION", "location": {"location_type": "AGENT_POS", "relative_direction": "DOWN"}, "reference_object": {"has_name": [[1, 1]]}}]}
put the blocks in my storage	{"dialogue_type": "HUMAN_GIVE_COMMAND", "action_sequence": [{"action_type": "OTHERACTION", "location": {"location_type": "REFERENCE_OBJECT", "relative_direction": "INSIDE", "reference_object": {"contains_coreference": "no", "has_name": [[4, 4], [5, 5]]}}, "reference_object": {"has_name": [[2, 2]]}}]}
put the box there	{"dialogue_type": "HUMAN_GIVE_COMMAND", "action_sequence": [{"action_type": "OTHERACTION", "location": {"contains_coreference": "yes"}, "reference_object": {"has_name": [[2, 2]]}}]}
put them in a pile	{"dialogue_type": "HUMAN_GIVE_COMMAND", "action_sequence": [{"action_type": "OTHERACTION", "location": [[2, 2], [4, 4]], "reference_object": {"contains_coreference": "yes"}}]}
put water in the hole	{"dialogue_type": "HUMAN_GIVE_COMMAND", "action_sequence": [{"action_type": "FILL", "has_block_type": [[1, 1]], "reference_object": {"has_name": [[4, 4]]}}]}
rebuild the building near the water	{"dialogue_type": "HUMAN_GIVE_COMMAND", "action_sequence": [{"action_type": "BUILD", "location": {"location_type": "REFERENCE_OBJECT", "relative_direction": "NEAR", "reference_object": {"contains_coreference": "no", "has_name": [[5, 5]]}}, "schematic": {"has_name": [[2, 2]]}}]}
remove obstructions first	{"dialogue_type": "HUMAN_GIVE_COMMAND", "action_sequence": [{"action_type": "DESTROY", "reference_object": {"has_name": [[1, 1]]}}]}
replace the new board in the old name board	{"dialogue_type": "HUMAN_GIVE_COMMAND", "action_sequence": [{"action_type": "OTHERACTION", "location": {"location_type": "REFERENCE_OBJECT", "relative_direction": "INSIDE", "reference_object": {"contains_coreference": "no", "has_name": [[7, 7], [8, 8]]}}, "reference_object": {"has_name": [[3, 3]], "has_tag": [[2, 2]]}}]}
replace the new name board	{"dialogue_type": "HUMAN_GIVE_COMMAND", "action_sequence": [{"action_type": "OTHERACTION", "reference_object": {"has_name": [[3, 3], [4, 4]]}}]}
replace the painting	{"dialogue_type": "HUMAN_GIVE_COMMAND", "action_sequence": [{"action_type": "OTHERACTION", "reference_object": {"has_name": [[2, 2]]}}]}
resume cleaning	{"dialogue_type": "HUMAN_GIVE_COMMAND", "action_sequence": [{"action_type": "RESUME", "target_action_type": [[1, 1]]}]}
resume digging	{"dialogue_type": "HUMAN_GIVE_COMMAND", "action_sequence": [{"action_type": "RESUME", "target_action_type": [[1, 1]]}]}
resume digging the hole	{"dialogue_type": "HUMAN_GIVE_COMMAND", "action_sequence": [{"action_type": "RESUME", "target_action_type": [[1, 1], [3, 3]]}]}
resume it later	{"dialogue_type": "HUMAN_GIVE_COMMAND", "action_sequence": [{"action_type": "RESUME", "target_action_type": [[1, 1]]}]}
resume making another building	{"dialogue_type": "HUMAN_GIVE_COMMAND", "action_sequence": [{"action_type": "RESUME", "target_action_type": [[1, 1], [2, 2], [3, 3]]}]}
resume moving 1 000 feet	{"dialogue_type": "HUMAN_GIVE_COMMAND", "action_sequence": [{"action_type": "RESUME", "target_action_type": [[1, 1], [2, 2], [3, 3], [4, 4]]}]}
resume pacing the floor	{"dialogue_type": "HUMAN_GIVE_COMMAND", "action_sequence": [{"action_type": "RESUME", "target_action_type": [[1, 1], [3, 3]]}]}
resume painting the house after	{"dialogue_type": "HUMAN_GIVE_COMMAND", "action_sequence": [{"action_type": "RESUME", "target_action_type": [[1, 1], [3, 3]]}]}
resume planting	{"dialogue_type": "HUMAN_GIVE_COMMAND", "action_sequence": [{"action_type": "RESUME", "target_action_type": [[1, 1]]}]}
resume recreating zombies	{"dialogue_type": "HUMAN_GIVE_COMMAND", "action_sequence": [{"action_type": "RESUME", "target_action_type": [[1, 1], [2, 2]]}]}
resume speech	{"dialogue_type": "HUMAN_GIVE_COMMAND", "action_sequence": [{"action_type": "RESUME", "target_action_type": [[1, 1]]}]}
resume the game after 5 minutes	{"dialogue_type": "HUMAN_GIVE_COMMAND", "action_sequence": [{"action_type": "RESUME", "target_action_type": [[2, 2]], "repeat": {"stop_condition": {"condition_span": [[3, 3], [4, 4], [5, 5]]}}}]}
resume the program	{"dialogue_type": "HUMAN_GIVE_COMMAND", "action_sequence": [{"action_type": "RESUME", "target_action_type": [[2, 2]]}]}
resume turning left	{"dialogue_type": "HUMAN_GIVE_COMMAND", "action_sequence": [{"action_type": "RESUME", "target_action_type": [[1, 1], [2, 2]]}]}
revert my loot to their initial spawn point	{"dialogue_type": "HUMAN_GIVE_COMMAND", "action_sequence": [{"action_type": "UNDO", "target_action_type": [[1, 1], [2, 2], [3, 3], [4, 4], [5, 5], [6, 6], [7, 7]]}]}
robot copy each page	{"dialogue_type": "HUMAN_GIVE_COMMAND", "action_sequence": [{"action_type": "COPY", "reference_object": {"has_name": [[3, 3]]}, "repeat": {"repeat_key": "ALL"}}]}
robot go out the backdoor	{"dialogue_type": "HUMAN_GIVE_COMMAND", "action_sequence": [{"action_type": "MOVE", "location": {"location_type": "REFERENCE_OBJECT", "relative_direction": "OUTSIDE", "reference_object": {"contains_coreference": "no", "has_name": [[4, 4]]}}}]}
robot take the stack of papers to the printer	{"dialogue_type": "HUMAN_GIVE_COMMAND", "action_sequence": [{"action_type": "OTHERACTION", "location": {"location_type": "REFERENCE_OBJECT", "reference_object": {"contains_coreference": "no", "has_name": [[8, 8]]}}, "reference_object": {"has_name": [[3, 3], [4, 4], [5, 5]]}}]}
save this into my notes	{"dialogue_type": "HUMAN_GIVE_COMMAND", "action_sequence": [{"action_type": "OTHERACTION", "location": {"location_type": "REFERENCE_OBJECT", "relative_direction": "INSIDE", "reference_object": {"contains_coreference": "no", "has_name": [[4, 4]]}}, "reference_object": {"contains_coreference": "yes"}}]}
say hello	{"dialogue_type": "HUMAN_GIVE_COMMAND", "action_sequence": [{"action_type": "OTHERACTION"}]}
say yeah	{"dialogue_type": "HUMAN_GIVE_COMMAND", "action_sequence": [{"action_type": "OTHERACTION"}]}
scout the surrounding area where the base was built	{"dialogue_type": "HUMAN_GIVE_COMMAND", "action_sequence": [{"action_type": "OTHERACTION", "location": {"location_type": "REFERENCE_OBJECT", "reference_object": {"contains_coreference": "no", "has_name": [[6, 6], [7, 7], [8, 8]]}}, "reference_object": {"has_name": [[3, 3]], "has_tag": [[2, 2]]}}]}
scratch your head	{"dialogue_type": "HUMAN_GIVE_COMMAND", "action_sequence": [{"action_type": "OTHERACTION", "reference_object": {"has_name": [[2, 2]]}}]}
search for minerals	{"dialogue_type": "HUMAN_GIVE_COMMAND", "action_sequence": [{"action_type": "OTHERACTION", "reference_object": {"has_name": [[2, 2]]}}]}
search for treasure at the beach	{"dialogue_type": "HUMAN_GIVE_COMMAND", "action_sequence": [{"action_type": "OTHERACTION", "location": {"location_type": "REFERENCE_OBJECT", "reference_object": {"contains_coreference": "no", "has_name": [[5, 5]]}}, "reference_object": {"has_name": [[2, 2]]}}]}
seek out the monk in a black robe	{"dialogue_type": "HUMAN_GIVE_COMMAND", "action_sequence": [{"action_type": "OTHERACTION", "reference_object": {"has_name": [[3, 3]], "has_tag": [[4, 4], [6, 6], [7, 7]]}}]}
smash the new wall	{"dialogue_type": "HUMAN_GIVE_COMMAND", "action_sequence": [{"action_type": "DESTROY", "reference_object": {"has_name": [[2, 2], [3, 3]]}}]}
spawn	{"dialogue_type": "HUMAN_GIVE_COMMAND", "action_sequence": [{"action_type": "SPAWN"}]}
spawn 10 pigs inside the hole	{"dialogue_type": "HUMAN_GIVE_COMMAND", "action_sequence": [{"action_type": "SPAWN", "location": {"location_type": "REFERENCE_OBJECT", "relative_direction": "INSIDE", "reference_object": {"contains_coreference": "no", "has_name": [[5, 5]]}}, "reference_object": {"has_name": [[2, 2]]}, "repeat": {"repeat_key": "FOR", "repeat_count": [[1, 1]]}}]}
spawn 2500 concrete blocks	{"dialogue_type": "HUMAN_GIVE_COMMAND", "action_sequence": [{"action_type": "SPAWN", "reference_object": {"has_name": [[3, 3]], "has_block_type": [[2, 2]]}, "repeat": {"repeat_key": "FOR", "repeat_count": [[1, 1]]}}]}
spawn 30 cows	{"dialogue_type": "HUMAN_GIVE_COMMAND", "action_sequence": [{"action_type": "SPAWN", "reference_object": {"has_name": [[2, 2]]}, "repeat": {"repeat_key": "FOR", "repeat_count": [[1, 1]]}}]}
spawn 50 wooden blocks	{"dialogue_type": "HUMAN_GIVE_COMMAND", "action_sequence": [{"action_type": "SPAWN", "reference_object": {"has_name": [[3, 3]], "has_block_type": [[2, 2]]}, "repeat": {"repeat_key": "FOR", "repeat_count": [[1, 1]]}}]}
spawn 80 deer	{"dialogue_type": "HUMAN_GIVE_COMMAND", "action_sequence": [{"action_type": "SPAWN", "reference_object": {"has_name": [[2, 2]]}, "repeat": {"repeat_key": "FOR", "repeat_count": [[1, 1]]}}]}
spawn a chair	{"dialogue_type": "HUMAN_GIVE_COMMAND", "action_sequence": [{"action_type": "SPAWN", "reference_object": {"has_name": [[2, 2]]}}]}
spawn a creature to attack	{"dialogue_type": "HUMAN_GIVE_COMMAND", "action_sequence": [{"action_type": "SPAWN", "reference_object": {"has_name": [[2, 2]]}}]}
spawn a creeper	{"dialogue_type": "HUMAN_GIVE_COMMAND", "action_sequence": [{"action_type": "SPAWN", "reference_object": {"has_name": [[2, 2]]}}]}
spawn a guitar hero guitar	{"dialogue_type": "HUMAN_GIVE_COMMAND", "action_sequence": [{"action_type": "SPAWN", "reference_object": {"has_name": [[2, 2], [3, 3], [4, 4]]}}]}
spawn a hammer	{"dialogue_type": "HUMAN_GIVE_COMMAND", "action_sequence": [{"action_type": "SPAWN", "reference_object": {"has_name": [[2, 2]]}}]}
spawn a hundred enemies	{"dialogue_type": "HUMAN_GIVE_COMMAND", "action_sequence": [{"action_type": "SPAWN", "reference_object": {"has_name": [[3, 3]]}, "repeat": {"repeat_key": "FOR", "repeat_count": [[2, 2]]}}]}
spawn a lantern	{"dialogue_type": "HUMAN_GIVE_COMMAND", "action_sequence": [{"action_type": "SPAWN", "reference_object": {"has_name": [[2, 2]]}}]}
spawn a shovel	{"dialogue_type": "HUMAN_GIVE_COMMAND", "action_sequence": [{"action_type": "SPAWN", "reference_object": {"has_name": [[2, 2]]}}]}
spawn a table	{"dialogue_type": "HUMAN_GIVE_COMMAND", "action_sequence": [{"action_type": "SPAWN", "reference_object": {"has_name": [[2, 2]]}}]}
spawn a tool	{"dialogue_type": "HUMAN_GIVE_COMMAND", "action_sequence": [{"action_type": "SPAWN", "reference_object": {"has_name": [[2, 2]]}}]}
spawn a zombie	{"dialogue_type": "HUMAN_GIVE_COMMAND", "action_sequence": [{"action_type": "SPAWN", "reference_object": {"has_name": [[2, 2]]}}]}
spawn an identical box	{"dialogue_type": "HUMAN_GIVE_COMMAND", "action_sequence": [{"action_type": "SPAWN", "reference_object": {"has_name": [[3, 3]], "has_tag": [[2, 2]]}}]}
spawn behind the character under the cut out wall	{"dialogue_type": "HUMAN_GIVE_COMMAND", "action_sequence": [{"action_type": "SPAWN", "location": {"location_type": "REFERENCE_OBJECT", "relative_direction": "BACK"}}]}
spawn four trees in this hole	{"dialogue_type": "HUMAN_GIVE_COMMAND", "action_sequence": [{"action_type": "SPAWN", "location": {"location_type": "REFERENCE_OBJECT", "relative_direction": "INSIDE", "reference_object": {"contains_coreference": "no", "has_name": [[4, 4], [5, 5]]}}, "reference_object": {"has_name": [[2, 2]]}, "repeat": {"repeat_key": "FOR", "repeat_count": [[1, 1]]}}]}
spawn growlights	{"dialogue_type": "HUMAN_GIVE_COMMAND", "action_sequence": [{"action_type": "SPAWN", "reference_object": {"has_name": [[1, 1]]}}]}
spawn pigs in the meadow	{"dialogue_type": "HUMAN_GIVE_COMMAND", "action_sequence": [{"action_type": "SPAWN", "location": {"location_type": "REFERENCE_OBJECT", "relative_direction": "INSIDE", "reference_object": {"contains_coreference": "no", "has_name": [[4, 4]]}}, "reference_object": {"has_name": [[1, 1]]}}]}
spawn some scouts to move	{"dialogue_type": "HUMAN_GIVE_COMMAND", "action_sequence": [{"action_type": "SPAWN", "reference_object": {"has_name": [[2, 2]]}}]}
spawn some stone blocks on the very top	{"dialogue_type": "HUMAN_GIVE_COMMAND", "action_sequence": [{"action_type": "SPAWN", "location": {"location_type": "REFERENCE_OBJECT", "reference_object": {"contains_coreference": "yes", "has_name": [[6, 6], [7, 7]]}}, "reference_object": {"has_name": [[3, 3]], "has_block_type": [[2, 2]]}}]}
spawn trees on one end	{"dialogue_type": "HUMAN_GIVE_COMMAND", "action_sequence": [{"action_type": "SPAWN", "location": {"location_type": "Other"}, "reference_object": {"has_name": [[1, 1]]}}]}
spin both the dice	{"dialogue_type": "HUMAN_GIVE_COMMAND", "action_sequence": [{"action_type": "OTHERACTION", "reference_object": {"has_name": [[3, 3]], "has_tag": [[1, 1]]}}]}
start building a base of operations	{"dialogue_type": "HUMAN_GIVE_COMMAND", "action_sequence": [{"action_type": "BUILD", "schematic": {"has_name": [[3, 3], [4, 4], [5, 5]]}}]}
start building a bridge	{"dialogue_type": "HUMAN_GIVE_COMMAND", "action_sequence": [{"action_type": "BUILD", "schematic": {"has_name": [[3, 3]]}}]}
start digging a hole	{"dialogue_type": "HUMAN_GIVE_COMMAND", "action_sequence": [{"action_type": "DIG", "schematic": {"has_name": [[3, 3]]}}]}
start to scream	{"dialogue_type": "HUMAN_GIVE_COMMAND", "action_sequence": [{"action_type": "OTHERACTION"}]}
step down	{"dialogue_type": "HUMAN_GIVE_COMMAND", "action_sequence": [{"action_type": "MOVE", "location": {"location_type": "AGENT_POS", "relative_direction": "DOWN"}}]}
stop	{"dialogue_type": "HUMAN_GIVE_COMMAND", "action_sequence": [{"action_type": "STOP"}]}
stop building	{"dialogue_type": "HUMAN_GIVE_COMMAND", "action_sequence": [{"action_type": "STOP", "target_action_type": [[1, 1]]}]}
stop carrying the brick	{"dialogue_type": "HUMAN_GIVE_COMMAND", "action_sequence": [{"action_type": "STOP", "target_action_type": [[1, 1], [3, 3]]}]}
stop destroying that wall	{"dialogue_type": "HUMAN_GIVE_COMMAND", "action_sequence": [{"action_type": "STOP", "target_action_type": [[1, 1], [2, 2], [3, 3]]}]}
stop digging the hole	{"dialogue_type": "HUMAN_GIVE_COMMAND", "action_sequence": [{"action_type": "STOP", "target_action_type": [[1, 1], [3, 3]]}]}
stop fighting	{"dialogue_type": "HUMAN_GIVE_COMMAND", "action_sequence": [{"action_type": "STOP", "target_action_type": [[1, 1]]}]}
stop forging the steel sword	{"dialogue_type": "HUMAN_GIVE_COMMAND", "action_sequence": [{"action_type": "STOP", "target_action_type": [[1, 1], [3, 3], [4, 4]]}]}
stop gathering rocks	{"dialogue_type": "HUMAN_GIVE_COMMAND", "action_sequence": [{"action_type": "STOP", "target_action_type": [[1, 1], [2, 2]]}]}
stop going north when you reach the church	{"dialogue_type": "HUMAN_GIVE_COMMAND", "action_sequence": [{"action_type": "STOP", "target_action_type": [[1, 1], [2, 2]]}]}
stop here	{"dialogue_type": "HUMAN_GIVE_COMMAND", "action_sequence": [{"action_type": "STOP"}]}
stop in front of the brown door	{"dialogue_type": "HUMAN_GIVE_COMMAND", "action_sequence": [{"action_type": "MOVE", "location": {"location_type": "REFERENCE_OBJECT", "relative_direction": "FRONT", "reference_object": {"contains_coreference": "no", "has_name": [[5, 5], [6, 6]]}}}]}
stop in front of the door	{"dialogue_type": "HUMAN_GIVE_COMMAND", "action_sequence": [{"action_type": "STOP"}]}
stop making coffee	{"dialogue_type": "HUMAN_GIVE_COMMAND", "action_sequence": [{"action_type": "STOP", "target_action_type": [[1, 1], [2, 2]]}]}
stop making the same structures	{"dialogue_type": "HUMAN_GIVE_COMMAND", "action_sequence": [{"action_type": "STOP", "target_action_type": [[1, 1], [3, 3], [4, 4]]}]}
stop moving	{"dialogue_type": "HUMAN_GIVE_COMMAND", "action_sequence": [{"action_type": "STOP", "target_action_type": [[1, 1]]}]}
stop rebooting	{"dialogue_type": "HUMAN_GIVE_COMMAND", "action_sequence": [{"action_type": "STOP", "target_action_type": [[1, 1]]}]}
stop removing the rock	{"dialogue_type": "HUMAN_GIVE_COMMAND", "action_sequence": [{"action_type": "STOP", "target_action_type": [[1, 1], [3, 3]]}]}
stop right there	{"dialogue_type": "HUMAN_GIVE_COMMAND", "action_sequence": [{"action_type": "STOP"}]}
stop software upgrade	{"dialogue_type": "HUMAN_GIVE_COMMAND", "action_sequence": [{"action_type": "STOP", "target_action_type": [[1, 1], [2, 2]]}]}
stop the game	{"dialogue_type": "HUMAN_GIVE_COMMAND", "action_sequence": [{"action_type": "STOP", "target_action_type": [[2, 2]]}]}
stop the program	{"dialogue_type": "HUMAN_GIVE_COMMAND", "action_sequence": [{"action_type": "STOP", "target_action_type": [[2, 2]]}]}
stop what you 're doing	{"dialogue_type": "HUMAN_GIVE_COMMAND", "action_sequence": [{"action_type": "STOP", "target_action_type": [[1, 1], [2, 2], [3, 3], [4, 4]]}]}
stop what you're doing	{"dialogue_type": "HUMAN_GIVE_COMMAND", "action_sequence": [{"action_type": "STOP", "target_action_type": [[1, 1], [2, 2], [3, 3]]}]}
stop when you find it	{"dialogue_type": "HUMAN_GIVE_COMMAND", "action_sequence": [{"action_type": "STOP"}]}
stop working on the new shed	{"dialogue_type": "HUMAN_GIVE_COMMAND", "action_sequence": [{"action_type": "STOP", "target_action_type": [[1, 1], [2, 2], [4, 4], [5, 5]]}]}
tag my brother	{"dialogue_type": "PUT_MEMORY", "action_sequence": [{"action_type": "TAG", "filters": {"reference_object": {"has_name": [[1, 1], [2, 2]]}}}]}
tag the box	{"dialogue_type": "PUT_MEMORY", "action_sequence": [{"action_type": "TAG", "filters": {"reference_object": {"has_name": [[2, 2]]}}}]}
tag the character on the pyramid	{"dialogue_type": "PUT_MEMORY", "action_sequence": [{"action_type": "TAG", "filters": {"reference_object": {"location": {"location_type": "REFERENCE_OBJECT", "reference_object": {"contains_coreference": "no", "has_name": [[5, 5]]}}, "has_name": [[2, 2]]}}}]}
tag wall on left	{"dialogue_type": "PUT_MEMORY", "action_sequence": [{"action_type": "TAG", "filters": {"reference_object": {"location": {"location_type": "AGENT_POS"}, "has_name": [[1, 1]]}}}]}
tag your teammate	{"dialogue_type": "PUT_MEMORY", "action_sequence": [{"action_type": "TAG", "filters": {"reference_object": {"has_name": [[2, 2]]}}}]}
take 5 steps backward	{"dialogue_type": "HUMAN_GIVE_COMMAND", "action_sequence": [{"action_type": "MOVE", "location": {"location_type": "AGENT_POS", "relative_direction": "BACK", "steps": [[1, 1]]}}]}
take cover	{"dialogue_type": "HUMAN_GIVE_COMMAND", "action_sequence": [{"action_type": "OTHERACTION"}]}
take the empty water bottles from kitchen	{"dialogue_type": "HUMAN_GIVE_COMMAND", "action_sequence": [{"action_type": "OTHERACTION", "location": {"location_type": "REFERENCE_OBJECT", "relative_direction": "AWAY", "reference_object": {"contains_coreference": "no", "has_name": [[6, 6]]}}, "reference_object": {"has_name": [[3, 3], [4, 4]], "has_tag": [[2, 2]]}}]}
take treasure	{"dialogue_type": "HUMAN_GIVE_COMMAND", "action_sequence": [{"action_type": "OTHERACTION", "reference_object": {"has_name": [[1, 1]]}}]}
talk to the player	{"dialogue_type": "HUMAN_GIVE_COMMAND", "action_sequence": [{"action_type": "OTHERACTION", "reference_object": {"has_name": [[3, 3]]}}]}
tear the building down	{"dialogue_type": "HUMAN_GIVE_COMMAND", "action_sequence": [{"action_type": "DESTROY", "reference_object": {"has_name": [[2, 2]]}}]}
tell me my schedule for today	{"dialogue_type": "HUMAN_GIVE_COMMAND", "action_sequence": [{"action_type": "OTHERACTION", "reference_object": {"has_name": [[3, 3]], "has_tag": [[4, 4], [5, 5]]}}]}
tell me the dice numbers now	{"dialogue_type": "HUMAN_GIVE_COMMAND", "action_sequence": [{"action_type": "ANSWER"}]}
tell my brother to stop spending money	{"dialogue_type": "HUMAN_GIVE_COMMAND", "action_sequence": [{"action_type": "OTHERACTION", "reference_object": {"has_name": [[1, 1], [2, 2]]}}]}
tell the operator you need help because you're trapped in a minecraft clone	{"dialogue_type": "HUMAN_GIVE_COMMAND", "action_sequence": [{"action_type": "OTHERACTION", "reference_object": {"has_name": [[2, 2]]}}]}
then destroy the tower	{"dialogue_type": "HUMAN_GIVE_COMMAND", "action_sequence": [{"action_type": "DESTROY", "reference_object": {"has_name": [[3, 3]]}}]}
then fill it in	{"dialogue_type": "HUMAN_GIVE_COMMAND", "action_sequence": [{"action_type": "FILL", "reference_object": {"contains_coreference": "yes"}}]}
throw it into the garbage	{"dialogue_type": "HUMAN_GIVE_COMMAND", "action_sequence": [{"action_type": "OTHERACTION", "location": {"location_type": "REFERENCE_OBJECT", "relative_direction": "INSIDE", "reference_object": {"contains_coreference": "no", "has_name": [[4, 4]]}}, "reference_object": {"contains_coreference": "yes"}}]}
travel east to the forest	{"dialogue_type": "HUMAN_GIVE_COMMAND", "action_sequence": [{"action_type": "MOVE", "location": {"location_type": "REFERENCE_OBJECT", "relative_direction": "RIGHT", "reference_object": {"contains_coreference": "no", "has_name": [[4, 4]]}}}]}
turn around	{"dialogue_type": "HUMAN_GIVE_COMMAND", "action_sequence": [{"action_type": "MOVE", "location": {"location_type": "AGENT_POS", "relative_direction": "AROUND"}}]}
turn left	{"dialogue_type": "HUMAN_GIVE_COMMAND", "action_sequence": [{"action_type": "OTHERACTION", "location": {"location_type": "AGENT_POS", "relative_direction": "LEFT"}}]}
turn right	{"dialogue_type": "HUMAN_GIVE_COMMAND", "action_sequence": [{"action_type": "MOVE", "location": {"location_type": "AGENT_POS", "relative_direction": "RIGHT"}}]}
turn the stovetop to medium heat	{"dialogue_type": "HUMAN_GIVE_COMMAND", "action_sequence": [{"action_type": "OTHERACTION", "reference_object": {"has_name": [[2, 2]]}}]}
undo dig	{"dialogue_type": "HUMAN_GIVE_COMMAND", "action_sequence": [{"action_type": "UNDO", "target_action_type": [[1, 1]]}]}
undo making those stairs	{"dialogue_type": "HUMAN_GIVE_COMMAND", "action_sequence": [{"action_type": "UNDO", "target_action_type": [[1, 1], [2, 2], [3, 3]]}]}
undo the chair you just spawned	{"dialogue_type": "HUMAN_GIVE_COMMAND", "action_sequence": [{"action_type": "UNDO", "target_action_type": [[2, 2], [3, 3], [4, 4], [5, 5]]}]}
undo the last block	{"dialogue_type": "HUMAN_GIVE_COMMAND", "action_sequence": [{"action_type": "UNDO", "target_action_type": [[2, 2], [3, 3]]}]}
undo the last building that i built	{"dialogue_type": "HUMAN_GIVE_COMMAND", "action_sequence": [{"action_type": "UNDO", "target_action_type": [[2, 2], [3, 3], [4, 4], [5, 5], [6, 6]]}]}
undo the last two spawns	{"dialogue_type": "HUMAN_GIVE_COMMAND", "action_sequence": [{"action_type": "UNDO", "target_action_type": [[2, 2], [3, 3], [4, 4]]}]}
use it to dig a tunnel under the door	{"dialogue_type": "HUMAN_GIVE_COMMAND", "action_sequence": [{"action_type": "DIG", "location": {"location_type": "REFERENCE_OBJECT", "relative_direction": "DOWN", "reference_object": {"contains_coreference": "no", "has_name": [[8, 8]]}}, "schematic": {"has_name": [[5, 5]]}}]}
use the recipe book to know how to craft it	{"dialogue_type": "HUMAN_GIVE_COMMAND", "action_sequence": [{"action_type": "OTHERACTION", "reference_object": {"has_name": [[2, 2], [3, 3]]}}]}
walk forward	{"dialogue_type": "HUMAN_GIVE_COMMAND", "action_sequence": [{"action_type": "MOVE", "location": {"location_type": "AGENT_POS", "relative_direction": "FRONT"}}]}
walk forward 10 feet	{"dialogue_type": "HUMAN_GIVE_COMMAND", "action_sequence": [{"action_type": "MOVE", "location": {"location_type": "AGENT_POS", "relative_direction": "FRONT", "steps": [[2, 2], [3, 3]]}}]}
walk forward through door	{"dialogue_type": "HUMAN_GIVE_COMMAND", "action_sequence": [{"action_type": "MOVE", "location": {"location_type": "REFERENCE_OBJECT"}}]}
walk out of the door that is opened	{"dialogue_type": "HUMAN_GIVE_COMMAND", "action_sequence": [{"action_type": "MOVE", "location": {"location_type": "REFERENCE_OBJECT", "relative_direction": "OUTSIDE", "reference_object": {"contains_coreference": "no", "has_name": [[4, 4], [5, 5], [6, 6], [7, 7]]}}}]}
walk out the open door	{"dialogue_type": "HUMAN_GIVE_COMMAND", "action_sequence": [{"action_type": "MOVE", "location": {"location_type": "REFERENCE_OBJECT", "relative_direction": "OUTSIDE", "reference_object": {"contains_coreference": "no", "has_name": [[4, 4]]}}}]}
walk outside	{"dialogue_type": "HUMAN_GIVE_COMMAND", "action_sequence": [{"action_type": "MOVE", "location": {"location_type": "AGENT_POS", "relative_direction": "OUTSIDE"}}]}
walk through the door	{"dialogue_type": "HUMAN_GIVE_COMMAND", "action_sequence": [{"action_type": "MOVE", "location": {"location_type": "REFERENCE_OBJECT"}}]}
walk through the wall	{"dialogue_type": "HUMAN_GIVE_COMMAND", "action_sequence": [{"action_type": "MOVE", "location": {"location_type": "REFERENCE_OBJECT"}}]}
walk to the door	{"dialogue_type": "HUMAN_GIVE_COMMAND", "action_sequence": [{"action_type": "MOVE", "location": {"location_type": "REFERENCE_OBJECT", "reference_object": {"contains_coreference": "no", "has_name": [[3, 3]]}}}]}
walk to the door that is leading outside	{"dialogue_type": "HUMAN_GIVE_COMMAND", "action_sequence": [{"action_type": "MOVE", "location": {"location_type": "REFERENCE_OBJECT", "reference_object": {"contains_coreference": "no", "has_name": [[3, 3], [4, 4], [5, 5], [6, 6], [7, 7]]}}}]}
walk to the player	{"dialogue_type": "HUMAN_GIVE_COMMAND", "action_sequence": [{"action_type": "MOVE", "location": {"location_type": "REFERENCE_OBJECT", "relative_direction": "NEAR", "reference_object": {"contains_coreference": "no", "has_name": [[3, 3]]}}}]}
walk to top of structure	{"dialogue_type": "HUMAN_GIVE_COMMAND", "action_sequence": [{"action_type": "MOVE", "location": {"location_type": "REFERENCE_OBJECT", "reference_object": {"contains_coreference": "no", "has_name": [[2, 2], [3, 3], [4, 4]]}}}]}
accelerate quickly to top speed towards the door	{"dialogue_type": "HUMAN_GIVE_COMMAND", "action_sequence": [{"action_type": "OTHERACTION", "location": {"location_type": "REFERENCE_OBJECT"}, "reference_object": {"has_name": [[4, 4]], "has_tag": [[3, 3]]}}]}
add other players' valuable moves and abilities to your arsenal	{"dialogue_type": "HUMAN_GIVE_COMMAND", "action_sequence": [{"action_type": "OTHERACTION", "location": {"location_type": "REFERENCE_OBJECT", "reference_object": {"contains_coreference": "no", "has_name": [[8, 8]]}}, "reference_object": {"has_name": [[1, 1], [2, 2], [3, 3], [4, 4], [5, 5], [6, 6]]}}]}
add schools to the city	{"dialogue_type": "HUMAN_GIVE_COMMAND", "action_sequence": [{"action_type": "BUILD", "location": {"location_type": "REFERENCE_OBJECT", "reference_object": {"contains_coreference": "no", "has_name": [[4, 4]]}}, "schematic": {"has_name": [[1, 1]]}}]}
add some planks for roof	{"dialogue_type": "HUMAN_GIVE_COMMAND", "action_sequence": [{"action_type": "BUILD", "schematic": {"has_name": [[2, 2]]}}]}
add some planks for walls	{"dialogue_type": "HUMAN_GIVE_COMMAND", "action_sequence": [{"action_type": "BUILD", "schematic": {"has_name": [[4, 4]], "has_block_type": [[2, 2]]}}]}
ask to use the bathroom	{"dialogue_type": "HUMAN_GIVE_COMMAND", "action_sequence": [{"action_type": "OTHERACTION", "reference_object": {"has_name": [[4, 4]]}}]}
bot shred mat into small pieces for me	{"dialogue_type": "HUMAN_GIVE_COMMAND", "action_sequence": [{"action_type": "DESTROY", "reference_object": {"has_name": [[2, 2]]}}]}
bot take that mat outside	{"dialogue_type": "HUMAN_GIVE_COMMAND", "action_sequence": [{"action_type": "OTHERACTION", "location": {"location_type": "REFERENCE_OBJECT", "relative_direction": "OUTSIDE", "reference_object": {"contains_coreference": "no"}}, "reference_object": {"contains_coreference": "yes", "has_name": [[3, 3]]}}]}
bring back to me	{"dialogue_type": "HUMAN_GIVE_COMMAND", "action_sequence": [{"action_type": "OTHERACTION", "location": {"location_type": "SPEAKER_POS"}}]}
click on it to exit the program	{"dialogue_type": "HUMAN_GIVE_COMMAND", "action_sequence": [{"action_type": "OTHERACTION", "location": [[1, 1], [2, 2]], "reference_object": {"contains_coreference": "yes"}}]}
climb the stairs	{"dialogue_type": "HUMAN_GIVE_COMMAND", "action_sequence": [{"action_type": "OTHERACTION", "reference_object": {"has_name": [[2, 2]]}}]}
climb the wall	{"dialogue_type": "HUMAN_GIVE_COMMAND", "action_sequence": [{"action_type": "OTHERACTION", "reference_object": {"has_name": [[2, 2]]}}]}
complete the destroy action	{"dialogue_type": "HUMAN_GIVE_COMMAND", "action_sequence": [{"action_type": "RESUME", "target_action_type": [[2, 2], [3, 3]]}]}
copy another playlist from my soundcloud	{"dialogue_type": "HUMAN_GIVE_COMMAND", "action_sequence": [{"action_type": "COPY", "reference_object": {"location": {"location_type": "REFERENCE_OBJECT", "reference_object": {"contains_coreference": "no", "has_name": [[4, 4], [5, 5]]}}, "has_name": [[2, 2]]}}]}
destroy the enemies one by one	{"dialogue_type": "HUMAN_GIVE_COMMAND", "action_sequence": [{"action_type": "DESTROY", "reference_object": {"has_name": [[2, 2]]}}]}
destroy the entire city	{"dialogue_type": "HUMAN_GIVE_COMMAND", "action_sequence": [{"action_type": "DESTROY", "reference_object": {"has_name": [[3, 3]]}}]}
dig another two feet	{"dialogue_type": "HUMAN_GIVE_COMMAND", "action_sequence": [{"action_type": "DIG", "schematic": {"has_name": [[3, 3]]}, "repeat": {"repeat_key": "FOR", "repeat_count": [[2, 2]]}}]}
dig down into the field 3 feet	{"dialogue_type": "HUMAN_GIVE_COMMAND", "action_sequence": [{"action_type": "DIG", "location": {"location_type": "REFERENCE_OBJECT", "relative_direction": "DOWN", "reference_object": {"has_name": [[4, 4]]}}, "schematic": {"has_depth": [[5, 5]]}}]}
dig out of corridor	{"dialogue_type": "HUMAN_GIVE_COMMAND", "action_sequence": [{"action_type": "DIG", "location": {"location_type": "REFERENCE_OBJECT", "relative_direction": "OUTSIDE", "reference_object": {"has_name": [[3, 3]]}}}]}
dig to hollow out the pyramid	{"dialogue_type": "HUMAN_GIVE_COMMAND", "action_sequence": [{"action_type": "DIG", "location": {"location_type": "REFERENCE_OBJECT", "reference_object": {"contains_coreference": "no", "has_name": [[5, 5]]}}, "repeat": {"stop_condition": {"condition_span": [[2, 2], [3, 3]]}}}]}
dig underground until you hit diamond	{"dialogue_type": "HUMAN_GIVE_COMMAND", "action_sequence": [{"action_type": "DIG", "location": {"location_type": "REFERENCE_OBJECT", "reference_object": {"contains_coreference": "no", "has_name": [[1, 1]]}}, "repeat": {"stop_condition": {"condition_type": "ADJACENT_TO_BLOCK_TYPE", "block_type": [[5, 5]]}}}]}
do a forward roll	{"dialogue_type": "HUMAN_GIVE_COMMAND", "action_sequence": [{"action_type": "DANCE"}]}
follow me to the well	{"dialogue_type": "HUMAN_GIVE_COMMAND", "action_sequence": [{"action_type": "MOVE", "location": {"location_type": "SPEAKER_POS"}, "repeat": {"stop_condition": {"condition_type": "ADJACENT_TO_BLOCK_TYPE", "block_type": [[4, 4]]}}}]}
gather 300 blocks of wood using your axe	{"dialogue_type": "HUMAN_GIVE_COMMAND", "action_sequence": [{"action_type": "OTHERACTION", "reference_object": {"has_name": [[2, 2]], "has_block_type": [[4, 4]], "has_tag": [[1, 1]]}}]}
get in the box	{"dialogue_type": "HUMAN_GIVE_COMMAND", "action_sequence": [{"action_type": "MOVE", "location": {"location_type": "REFERENCE_OBJECT", "relative_direction": "INSIDE", "reference_object": {"contains_coreference": "no", "has_name": [[3, 3]]}}}]}
go run	{"dialogue_type": "HUMAN_GIVE_COMMAND", "action_sequence": [{"action_type": "MOVE"}]}
go to the building directly in front of you	{"dialogue_type": "HUMAN_GIVE_COMMAND", "action_sequence": [{"action_type": "MOVE", "location": {"location_type": "REFERENCE_OBJECT", "reference_object": {"has_name": [[3, 3]], "location": {"location_type": "AGENT_POS", "relative_direction": "FRONT"}}}}]}
if you can see any land dig it	{"dialogue_type": "HUMAN_GIVE_COMMAND", "action_sequence": [{"action_type": "DIG", "location": [[5, 5]], "repeat": {"repeat_key": "ALL", "repeat_dir": "DOWN"}}]}
jump off stairs	{"dialogue_type": "HUMAN_GIVE_COMMAND", "action_sequence": [{"action_type": "DANCE", "location": {"location_type": "REFERENCE_OBJECT", "relative_direction": "AWAY", "reference_object": {"contains_coreference": "no", "has_name": [[2, 2]]}}}]}
jump up in the air	{"dialogue_type": "HUMAN_GIVE_COMMAND", "action_sequence": [{"action_type": "MOVE", "location": {"location_type": "REFERENCE_OBJECT", "relative_direction": "INSIDE", "reference_object": {"contains_coreference": "yes", "has_name": [[4, 4]]}}}]}
lay down	{"dialogue_type": "HUMAN_GIVE_COMMAND", "action_sequence": [{"action_type": "OTHERACTION", "reference_object": {"location": {"location_type": "AGENT_POS", "relative_direction": "DOWN"}, "has_tag": [[0, 0]]}}]}
look forward	{"dialogue_type": "HUMAN_GIVE_COMMAND", "action_sequence": [{"action_type": "OTHERACTION", "location": {"location_type": "AGENT_POS", "relative_direction": "FRONT"}}]}
make a dig	{"dialogue_type": "HUMAN_GIVE_COMMAND", "action_sequence": [{"action_type": "DIG"}]}
make a new block at this new spot	{"dialogue_type": "HUMAN_GIVE_COMMAND", "action_sequence": [{"action_type": "BUILD", "location": {"location_type": "REFERENCE_OBJECT", "reference_object": {"contains_coreference": "no", "has_name": [[5, 5], [6, 6], [7, 7]]}}, "schematic": {"has_name": [[3, 3]], "has_tag": [[2, 2]]}}]}
make one tower green	{"dialogue_type": "HUMAN_GIVE_COMMAND", "action_sequence": [{"action_type": "OTHERACTION", "reference_object": {"has_name": [[2, 2]], "has_tag": [[1, 1]]}}]}
move all of the timber to the front of the fort	{"dialogue_type": "HUMAN_GIVE_COMMAND", "action_sequence": [{"action_type": "OTHERACTION", "location": {"location_type": "REFERENCE_OBJECT", "relative_direction": "FRONT", "reference_object": {"contains_coreference": "no", "has_name": [[10, 10]]}}, "reference_object": {"has_name": [[4, 4]]}, "repeat": {"repeat_key": "ALL", "repeat_dir": "FRONT"}}]}
move all the materials from excavating into one pile	{"dialogue_type": "HUMAN_GIVE_COMMAND", "action_sequence": [{"action_type": "OTHERACTION", "location": {"location_type": "REFERENCE_OBJECT", "relative_direction": "INSIDE", "reference_object": {"contains_coreference": "no", "has_name": [[7, 7], [8, 8]]}}, "reference_object": {"has_name": [[3, 3]]}, "repeat": {"repeat_key": "ALL"}}]}
move all the rocks away from the river	{"dialogue_type": "HUMAN_GIVE_COMMAND", "action_sequence": [{"action_type": "OTHERACTION", "location": {"location_type": "REFERENCE_OBJECT", "relative_direction": "AWAY", "reference_object": {"contains_coreference": "no", "has_name": [[7, 7]]}}, "reference_object": {"has_name": [[3, 3]]}}]}
move dirt to the side of the house	{"dialogue_type": "HUMAN_GIVE_COMMAND", "action_sequence": [{"action_type": "OTHERACTION", "location": {"location_type": "REFERENCE_OBJECT", "reference_object": {"contains_coreference": "no", "has_name": [[4, 4], [5, 5], [7, 7]]}}, "reference_object": {"has_name": [[1, 1]]}}]}
move forward five blocks	{"dialogue_type": "HUMAN_GIVE_COMMAND", "action_sequence": [{"action_type": "MOVE", "location": {"location_type": "AGENT_POS", "relative_direction": "FRONT", "steps": [[2, 2]]}}]}
move over to the left	{"dialogue_type": "HUMAN_GIVE_COMMAND", "action_sequence": [{"action_type": "MOVE", "location": {"location_type": "AGENT_POS", "relative_direction": "LEFT"}}]}
move that boulder	{"dialogue_type": "HUMAN_GIVE_COMMAND", "action_sequence": [{"action_type": "OTHERACTION", "reference_object": {"contains_coreference": "yes", "has_name": [[1, 1], [2, 2]]}}]}
move these blocks around	{"dialogue_type": "HUMAN_GIVE_COMMAND", "action_sequence": [{"action_type": "OTHERACTION", "location": [[3, 3]], "reference_object": {"contains_coreference": "yes", "has_name": [[1, 1], [2, 2]]}}]}
move to a good area to dig a foundation	{"dialogue_type": "HUMAN_GIVE_COMMAND", "action_sequence": [{"action_type": "MOVE", "location": {"location_type": "REFERENCE_OBJECT", "relative_direction": "NEAR", "reference_object": {"contains_coreference": "no", "has_name": [[3, 3], [4, 4]]}}}]}
move to the right	{"dialogue_type": "HUMAN_GIVE_COMMAND", "action_sequence": [{"action_type": "MOVE", "location": {"location_type": "AGENT_POS", "relative_direction": "RIGHT"}}]}
move towards the hole	{"dialogue_type": "HUMAN_GIVE_COMMAND", "action_sequence": [{"action_type": "MOVE", "location": {"location_type": "REFERENCE_OBJECT"}}]}
open it	{"dialogue_type": "HUMAN_GIVE_COMMAND", "action_sequence": [{"action_type": "OTHERACTION", "reference_object": {"contains_coreference": "yes"}}]}
paint it red on the walls	{"dialogue_type": "HUMAN_GIVE_COMMAND", "action_sequence": [{"action_type": "OTHERACTION", "location": {"location_type": "REFERENCE_OBJECT", "reference_object": {"contains_coreference": "no", "has_name": [[5, 5]]}}, "reference_object": {"contains_coreference": "yes", "has_colour": [[2, 2]]}}]}
paint the kitchen with the colour scheme of the living room	{"dialogue_type": "HUMAN_GIVE_COMMAND", "action_sequence": [{"action_type": "OTHERACTION", "reference_object": {"has_name": [[2, 2]], "has_colour": [[5, 5], [6, 6], [9, 9], [10, 10]]}}]}
place them in a line	{"dialogue_type": "HUMAN_GIVE_COMMAND", "action_sequence": [{"action_type": "OTHERACTION", "location": {"location_type": "REFERENCE_OBJECT", "reference_object": {"has_name": [[4, 4]]}}, "reference_object": {"contains_coreference": "yes"}, "repeat": {"repeat_key": "ALL"}}]}
plant a garden of tomatoes cucumbers strawberries and blueberries	{"dialogue_type": "HUMAN_GIVE_COMMAND", "action_sequence": [{"action_type": "BUILD", "schematic": {"has_name": [[2, 2]], "has_block_type": [[4, 4], [5, 5], [6, 6]]}}]}
please put small amounts of paper in fireplace	{"dialogue_type": "HUMAN_GIVE_COMMAND", "action_sequence": [{"action_type": "OTHERACTION", "location": {"location_type": "REFERENCE_OBJECT", "relative_direction": "INSIDE", "reference_object": {"contains_coreference": "no", "has_name": [[7, 7]]}}, "reference_object": {"has_name": [[5, 5]], "has_size": [[2, 2], [3, 3]]}}]}
prepare to run into the house	{"dialogue_type": "HUMAN_GIVE_COMMAND", "action_sequence": [{"action_type": "OTHERACTION", "reference_object": {"location": {"location_type": "REFERENCE_OBJECT", "relative_direction": "INSIDE", "reference_object": {"contains_coreference": "no", "has_name": [[5, 5]]}}, "has_name": [[5, 5]]}}]}
prepare to watch the other player in the distance	{"dialogue_type": "HUMAN_GIVE_COMMAND", "action_sequence": [{"action_type": "OTHERACTION", "reference_object": {"location": {"location_type": "REFERENCE_OBJECT", "reference_object": {"contains_coreference": "no", "has_name": [[8, 8]]}}, "has_name": [[4, 4], [5, 5]]}}]}
propel from the undo	{"dialogue_type": "HUMAN_GIVE_COMMAND", "action_sequence": [{"action_type": "OTHERACTION", "location": {"location_type": "REFERENCE_OBJECT", "relative_direction": "AWAY", "reference_object": {"contains_coreference": "no", "has_name": [[3, 3]]}}}]}
rebuild the purple pyramid	{"dialogue_type": "HUMAN_GIVE_COMMAND", "action_sequence": [{"action_type": "BUILD", "schematic": {"has_name": [[3, 3]], "has_colour": [[2, 2]]}}]}
repeat the sequence starting with step 2 until bank is full	{"dialogue_type": "HUMAN_GIVE_COMMAND", "action_sequence": [{"action_type": "OTHERACTION", "reference_object": {"has_name": [[2, 2]], "has_tag": [[3, 3], [4, 4], [5, 5], [6, 6]]}, "repeat": {"stop_condition": {"condition_span": [[8, 8], [9, 9], [10, 10]]}}}]}
replace with a tower	{"dialogue_type": "HUMAN_GIVE_COMMAND", "action_sequence": [{"action_type": "OTHERACTION", "reference_object": {"has_name": [[3, 3]]}}]}
reporting any object you see hiding on the way	{"dialogue_type": "HUMAN_GIVE_COMMAND", "action_sequence": [{"action_type": "OTHERACTION", "reference_object": {"location": {"location_type": "REFERENCE_OBJECT", "reference_object": {"has_name": [[6, 6], [8, 8]]}}, "has_name": [[2, 2]], "has_tag": [[5, 5]]}}]}
robot take the stack of papers on my desk	{"dialogue_type": "HUMAN_GIVE_COMMAND", "action_sequence": [{"action_type": "OTHERACTION", "location": {"location_type": "REFERENCE_OBJECT", "reference_object": {"contains_coreference": "no", "has_name": [[6, 6], [7, 7], [8, 8]]}}, "reference_object": {"has_name": [[3, 3], [4, 4], [5, 5]]}, "repeat": {"repeat_key": "ALL"}}]}
robot take the steps down from the deck	{"dialogue_type": "HUMAN_GIVE_COMMAND", "action_sequence": [{"action_type": "MOVE", "location": {"location_type": "REFERENCE_OBJECT", "relative_direction": "DOWN", "reference_object": {"contains_coreference": "no", "has_name": [[7, 7]]}}}]}
see if there is any new mail in the mailbox	{"dialogue_type": "HUMAN_GIVE_COMMAND", "action_sequence": [{"action_type": "OTHERACTION", "location": {"location_type": "REFERENCE_OBJECT", "relative_direction": "INSIDE", "reference_object": {"contains_coreference": "no", "has_name": [[9, 9]]}}, "reference_object": {"location": {"location_type": "REFERENCE_OBJECT", "relative_direction": "INSIDE", "reference_object": {"contains_coreference": "no"}}, "has_name": [[5, 5], [6, 6]]}}]}
sit on it	{"dialogue_type": "HUMAN_GIVE_COMMAND", "action_sequence": [{"action_type": "DANCE", "location": {"location_type": "REFERENCE_OBJECT"}}]}
sit on the blue block by my feet	{"dialogue_type": "HUMAN_GIVE_COMMAND", "action_sequence": [{"action_type": "DANCE", "location": {"location_type": "SPEAKER_POS", "relative_direction": "NEAR"}}]}
spawn in the kitchen	{"dialogue_type": "HUMAN_GIVE_COMMAND", "action_sequence": [{"action_type": "SPAWN", "location": {"location_type": "REFERENCE_OBJECT", "relative_direction": "INSIDE", "reference_object": {"contains_coreference": "no", "has_name": [[3, 3]]}}}]}
spawn numerous tropical and flowering plants in this hole	{"dialogue_type": "HUMAN_GIVE_COMMAND", "action_sequence": [{"action_type": "SPAWN", "location": {"location_type": "REFERENCE_OBJECT", "relative_direction": "INSIDE", "reference_object": {"contains_coreference": "no", "has_name": [[8, 8]]}}, "reference_object": {"has_name": [[5, 5]], "has_size": [[1, 1]], "has_tag": [[2, 2], [3, 3], [4, 4]]}}]}
spawn pink blocks in place of blue blocks	{"dialogue_type": "HUMAN_GIVE_COMMAND", "action_sequence": [{"action_type": "SPAWN", "location": {"location_type": "REFERENCE_OBJECT", "reference_object": {"contains_coreference": "no", "has_name": [[6, 6], [7, 7]]}}, "reference_object": {"has_name": [[2, 2]], "has_colour": [[1, 1]]}}]}
spawn some more workers in order to finish construction	{"dialogue_type": "HUMAN_GIVE_COMMAND", "action_sequence": [{"action_type": "SPAWN", "reference_object": {"has_name": [[3, 3]]}}]}
stan on the mountain	{"dialogue_type": "HUMAN_GIVE_COMMAND", "action_sequence": [{"action_type": "MOVE", "location": {"location_type": "REFERENCE_OBJECT", "reference_object": {"contains_coreference": "no", "has_name": [[3, 3]]}}}]}
stand on top of the structure	{"dialogue_type": "HUMAN_GIVE_COMMAND", "action_sequence": [{"action_type": "MOVE", "location": {"location_type": "REFERENCE_OBJECT", "relative_direction": "UP", "reference_object": {"contains_coreference": "no", "has_name": [[5, 5]]}}}]}
start a new build	{"dialogue_type": "HUMAN_GIVE_COMMAND", "action_sequence": [{"action_type": "BUILD"}]}
start moving slowly towards the door	{"dialogue_type": "HUMAN_GIVE_COMMAND", "action_sequence": [{"action_type": "MOVE", "location": {"location_type": "REFERENCE_OBJECT", "relative_direction": "NEAR", "reference_object": {"contains_coreference": "no", "has_name": [[5, 5]]}}}]}
start playing music	{"dialogue_type": "HUMAN_GIVE_COMMAND", "action_sequence": [{"action_type": "OTHERACTION", "reference_object": {"has_name": [[2, 2]]}}]}
stop after five spaces	{"dialogue_type": "HUMAN_GIVE_COMMAND", "action_sequence": [{"action_type": "MOVE", "location": [[3, 3]], "repeat": {"repeat_key": "FOR", "repeat_count": [[2, 2]]}}]}
stop at the lake	{"dialogue_type": "HUMAN_GIVE_COMMAND", "action_sequence": [{"action_type": "STOP", "repeat": {"stop_condition": {"condition_type": "ADJACENT_TO_BLOCK_TYPE", "block_type": [[1, 1], [3, 3]]}}}]}
stop digging the fill hole with the box in your hands	{"dialogue_type": "HUMAN_GIVE_COMMAND", "action_sequence": [{"action_type": "STOP", "target_action_type": [[1, 1], [3, 3], [4, 4]]}]}
stop when you get to the building	{"dialogue_type": "HUMAN_GIVE_COMMAND", "action_sequence": [{"action_type": "STOP", "target_action_type": [[1, 1], [2, 2], [3, 3], [4, 4], [6, 6]]}]}
swing your right arm in a circle like a windmill	{"dialogue_type": "HUMAN_GIVE_COMMAND", "action_sequence": [{"action_type": "DANCE"}]}
tage that name board	{"dialogue_type": "PUT_MEMORY", "action_sequence": [{"action_type": "TAG", "filters": {"reference_object": {"contains_coreference": "yes"}}, "tag_val": [[2, 2], [3, 3]], "upsert": {"memory_data": {"memory_type": "TRIPLE"}}}]}
take 5 steps forward	{"dialogue_type": "HUMAN_GIVE_COMMAND", "action_sequence": [{"action_type": "MOVE", "location": {"location_type": "AGENT_POS", "relative_direction": "FRONT"}, "repeat": {"repeat_key": "FOR", "repeat_count": [[1, 1]], "repeat_dir": "FRONT"}}]}
try making unique buildings without destroying things	{"dialogue_type": "HUMAN_GIVE_COMMAND", "action_sequence": [{"action_type": "BUILD", "schematic": {"has_name": [[3, 3]], "has_tag": [[2, 2]]}}]}
try to find diamond blocks	{"dialogue_type": "HUMAN_GIVE_COMMAND", "action_sequence": [{"action_type": "OTHERACTION", "reference_object": {"has_name": [[4, 4]], "has_block_type": [[3, 3]]}}]}
turn my loot into lava	{"dialogue_type": "HUMAN_GIVE_COMMAND", "action_sequence": [{"action_type": "OTHERACTION", "reference_object": {"has_name": [[2, 2]]}}]}
turn to your left	{"dialogue_type": "HUMAN_GIVE_COMMAND", "action_sequence": [{"action_type": "OTHERACTION", "location": {"location_type": "AGENT_POS", "relative_direction": "LEFT"}}]}
turn to your right	{"dialogue_type": "HUMAN_GIVE_COMMAND", "action_sequence": [{"action_type": "OTHERACTION", "location": {"location_type": "AGENT_POS", "relative_direction": "RIGHT"}}]}
undo this wall i built	{"dialogue_type": "HUMAN_GIVE_COMMAND", "action_sequence": [{"action_type": "UNDO", "target_action_type": [[1, 1], [2, 2], [3, 3], [4, 4]]}]}
use the dirt from the large hole to help build our new shed	{"dialogue_type": "HUMAN_GIVE_COMMAND", "action_sequence": [{"action_type": "BUILD", "schematic": {"has_name": [[12, 12]], "has_block_type": [[2, 2], [3, 3], [5, 5], [6, 6]]}}]}
use the pc to mine crypto currency for me	{"dialogue_type": "HUMAN_GIVE_COMMAND", "action_sequence": [{"action_type": "OTHERACTION", "location": [[2, 2]], "reference_object": {"has_name": [[5, 5], [6, 6]]}}]}
use these steps as the entryway of the house	{"dialogue_type": "HUMAN_GIVE_COMMAND", "action_sequence": [{"action_type": "OTHERACTION", "location": {"location_type": "REFERENCE_OBJECT", "reference_object": {"contains_coreference": "no", "has_name": [[5, 5], [6, 6], [8, 8]]}}, "reference_object": {"has_name": [[2, 2]]}}]}
wait for a few seconds	{"dialogue_type": "HUMAN_GIVE_COMMAND", "action_sequence": [{"action_type": "STOP", "repeat": {"stop_condition": {"condition_span": [[1, 1], [3, 3], [4, 4]]}}}]}
walk over to the brown boulder	{"dialogue_type": "HUMAN_GIVE_COMMAND", "action_sequence": [{"action_type": "MOVE", "location": {"location_type": "REFERENCE_OBJECT", "reference_object": {"contains_coreference": "no", "has_name": [[4, 4], [5, 5]]}}}]}
welcome visitors	{"dialogue_type": "HUMAN_GIVE_COMMAND", "action_sequence": [{"action_type": "OTHERACTION", "reference_object": {"has_name": [[1, 1]]}}]}
would you stop the current playlist	{"dialogue_type": "HUMAN_GIVE_COMMAND", "action_sequence": [{"action_type": "STOP", "target_action_type": [[4, 4], [5, 5]]}]}
